"aa" = (/turf/wall/generic,/area/underground)
"ab" = (/turf/wall/rock,/area/underground)
"ac" = (/turf/floor/generic/wooden,/area/underground)
"ad" = (/obj/electricity/lightbulb/east,/turf/floor/generic/wooden,/area/underground)
"ae" = (/liquid/lava,/turf/floor/rock,/area/underground)
"af" = (/obj/electricity/lightbulb/west,/turf/floor/generic/wooden,/area/underground)
"ag" = (/obj/electricity/lightbulb,/turf/floor/generic/wooden,/area/underground)
"ah" = (/obj/electricity/machine/door,/turf/floor/generic/red,/area/underground)
"ai" = (/obj/electricity/lightbulb/north,/turf/floor/generic/red,/area/underground)
"aj" = (/turf/floor/generic/red,/area/underground)
"ak" = (/turf/wall/window,/area/underground)
"al" = (/obj/electricity/lightswitch/east,/turf/floor/generic/wooden,/area/underground)
"am" = (/obj/electricity/lightbulb,/turf/floor/generic/red,/area/underground)
"an" = (/obj/electricity/elevator/button/west,/turf/floor/generic/red,/area/underground)
"ao" = (/obj/electricity/machine/door,/turf/floor/generic/black,/area/underground)
"ap" = (/turf/wall/generic,/area/elevator)
"aq" = (/obj/electricity/machine/door/elevator_door,/turf/floor/generic/black,/area/elevator)
"ar" = (/turf/floor/generic/black,/area/underground)
"as" = (/turf/floor/generic/chess,/area/underground)
"at" = (/obj/electricity/elevator/button/east,/turf/floor/generic/chess,/area/underground)
"au" = (/turf/floor/generic/black,/area/elevator)
"av" = (/obj/electricity/elevator/controls/north,/turf/floor/generic/black,/area/elevator)
"aw" = (/obj/electricity/elevator/button/west,/turf/floor/generic/chess,/area/underground)
"ax" = (/obj/electricity/lightbulb,/turf/floor/generic/black,/area/underground)
"ay" = (/obj/electricity/lightbulb/west,/turf/floor/generic/chess,/area/underground)
"az" = (/obj/electricity/lightbulb/east,/turf/floor/generic/chess,/area/underground)
"aA" = (/obj/electricity/lightbulb/west,/turf/floor/generic/black,/area/elevator)
"aB" = (/obj/electricity/lightbulb/east,/turf/floor/generic/black,/area/elevator)
"aC" = (/obj/electricity/machine/door,/turf/floor/generic/chess,/area/underground)
"aD" = (/liquid/lava,/turf/floor/generic/wooden,/area/underground)
"aE" = (/turf/floor/generic/white,/area/underground)
"aF" = (/obj/item/ball,/turf/floor/generic/wooden,/area/underground)
"aG" = (/obj/electricity/lightbulb/west,/turf/floor/generic/red,/area/underground)
"aH" = (/obj/electricity/lightbulb/east,/turf/floor/generic/red,/area/underground)
"aI" = (/obj/electricity/lightbulb/west,/turf/floor/generic/white,/area/underground)
"aJ" = (/liquid/water,/turf/floor/generic/wooden,/area/underground)
"aK" = (/turf/floor/rock,/area/underground)
"aL" = (/obj/electricity/elevator/button/west,/turf/floor/rock,/area/underground)
"aM" = (/obj/electricity/lightbulb/east,/turf/floor/rock,/area/underground)
"aN" = (/turf/wall/generic,/area/elevator{name = "Elevator0"})
"aO" = (/obj/electricity/machine/door/elevator_door,/turf/floor/generic/black,/area/elevator{name = "Elevator0"})
"aP" = (/turf/floor/generic/black,/area/elevator{name = "Elevator0"})
"aQ" = (/obj/electricity/lightbulb/north,/turf/floor/generic/chess,/area/underground)
"aR" = (/obj/electricity/elevator/button/east,/turf/floor/generic/red,/area/underground)
"aS" = (/obj/electricity/lightbulb/south,/turf/floor/generic/chess,/area/underground)
"aT" = (/obj/electricity/elevator/button/north,/turf/floor/rock,/area/underground)
"aU" = (/obj/electricity/lightbulb/north,/turf/floor/rock,/area/underground)
"aV" = (/obj/electricity/lightbulb,/turf/floor/rock,/area/underground)
"aW" = (/obj/electricity/lightbulb/south,/turf/floor/generic/red,/area/underground)
"aX" = (/obj/electricity/lightbulb/south,/turf/floor/rock,/area/underground)
"aY" = (/obj/electricity/elevator/button/south,/turf/floor/rock,/area/underground)
"aZ" = (/turf/wall/generic,/area/elevator{name = "Elevator1"})
"ba" = (/obj/electricity/machine/door/elevator_door,/turf/floor/generic/black,/area/elevator{name = "Elevator1"})
"bb" = (/turf/floor/generic/black,/area/elevator{name = "Elevator1"})
"bc" = (/obj/electricity/lightbulb/west,/turf/floor/rock,/area/underground)
"bd" = (/obj/electricity/elevator/button/east,/turf/floor/rock,/area/underground)
"be" = (/turf,/area/underground)

(1,1,1) = {"
aaaaaaaaaaaaaaaaaaaaaaaaaaaaaaababababababababababababababab
aaacacacacacacacacacacacacadaaabaeaeaeaeaeaeaeaeaeaeaeaeaeab
aaafacacacacacacacacacacacadaaababababaeaeaeaeaeaeaeaeaeaeab
aaacacacacacagacacacacadaaaaaaaaaaaaabaeaeaeaeaeaeaeaeaeaeab
aaacacacacacacacacacacacahaiajajaiahakaeaeaeaeaeaeaeaeaeaeab
aaacacacacacacacacacacacahajajajajahakaeaeaeaeaeaeaeaeaeaeab
aaacacacacacacacacacacacahajajajajahakaeaeaeaeaeaeaeaeaeaeab
aaacacacacacagacacacacalaaajajajajaaabaeaeaeaeaeaeaeaeaeaeab
aaafacacacacacacacacacadaaamajajamaaabaeaeaeaeaeaeaeaeaeaeab
aaacacacacacacacacacacacaaanajajajaaababababababababababakab
aaaoaaaaaaaaaaaaaaaaapapapaqaqaqaqapapapaaaaaaaaaaaaaaaaaoaa
aaaraaasasasasasasatapauavauauauauauauapawasasasasasasaaaraa
aaaxaaayasasasasasazapaAauauauauauauaBapayasasasasasasaaaxaa
aaaraCasasasasasasasaqauauauauauauauauaqasasasasasasasaCaraa
aaaraaayasasasasasasaqauauauauauauauauaqasasasasasasasaaaraa
aaaxakasasasasasasazapaAauauauauauauaBapayasasasasasasakaxaa
aaarakasasasasasasasapauauauauauauauauapasasasasasasasakaraa
aaaoaaaaaaaaaaaaaaaaapapapaqaqaqaqapapapaaaaaaaaaaaaaaaaaoaa
aaacacacacacacacacacacaDaaanajajajaaaEaEaEaEaEaEaEaEaEaEaEaa
aaacacacacacacacacacacacaaajajajajaaaEaEaEaEaEaEaEaEaEaEaEaa
aaacacacacacacacacacacacakajajajajakaEaEaEaEaEaEaEaEaEaEaEaa
aaacacacagacaFacagacacadaaaGajajaHaaaIaEaEaEaEaEaEaEaEaEaEaa
aaacacacacacacacacacacacakajajajajakaEaEaEaEaEaEaEaEaEaEaEaa
aaacacacacacacacacacacadaaaGajajaHaaaIaEaEaEaEaEaEaEaEaEaEaa
aaacacacacacacacacacacacakajajajajakaEaEaEaEaEaEaEaEaEaEaEaa
aaacacacagacacacagacacacaaajajajajaaaEaEaEaEaEaEaEaEaEaEaEaa
aaacacacacacacacacacacacahajajajajahaEaEaEaEaEaEaEaEaEaEaEaa
aaacacacacacacacacacacacahajajajajahaEaEaEaEaEaEaEaEaEaEaEaa
aaaJacacacacacacacacacacahajajajajahaEaEaEaEaEaEaEaEaEaEaEaa
aaaaaaaaaaaaaaaaaaaaaaaaaaaaaaaaaaaaaaaaaaaaaaaaaaaaaaaaaaaa
"}

(1,1,2) = {"
abababababababababababababababababababababababababababababab
ababababababababababababababababaKaKaKaKaKababababababababab
abababababababababababababababaKaKaKabaKaKaKabababababababab
abababababababababababababababaKaKaKababaKaKaKababababababab
ababababababababababababababababaKaKaKababaKaKaKaKaKaKaKabab
abababababababababababababababababaKaKaKabababababababaKabab
abababababababababababababababababababababababababababaKabab
ababaKaKaKaKaKaKaKaKaKaKaKaKaKaKaKaKaKaKaKaKaKaKaKaKaKaKabab
ababaKaKaKaKaKaKaKaKaKaKaKaKaKaKaKaKaKaKaKaKaKaKaKaKaKaKabab
ababaKaKabababababababababaLaKaKaMabababababababababaKaKabab
aaaaahahaaaaaaaaaaaaaNaNaNaOaOaOaOaNaNaNaaaaaaaaaaaaaCaCaaaa
aaajajajajajajajajajaNaPaPaPaPaPaPaPaPaNasasasaQasaQasasasaa
aaajajajajajajajajaRaNaPaPaPaPaPaPaPaPaNawasasasasasasasasaa
aaajajajajajajajajajaOaPaPaPaPaPaPaPaPaOasasasasasasasasasaa
aaajajajamajamajajajaOaPaPaPaPaPaPaPaPaOasasasasasasasasasaa
aaajajajajajajajajajaNaPaPaPaPaPaPaPaPaNasasasasasasasasasaa
aaajajajajajajajajajaNaPaPaPaPaPaPaPaPaNasasasaSasaSasasasaa
aaajajajajajajajajajaNaNaNaOaOaOaOaNaNaNaaaaaaaaaaaaaCaCaaaa
aaajajajajajajajajajaaabaTaKabababababababababababababaKaUab
aaajajajajajajajajajaaababaVaKaKaKaKaKaKaKaKaKaKaKaKababaKab
aaajajajajajajajajajaaababababababababaKababaKababaKababaKab
aaajajajajajajajajajaaabaKaKaKaKaKaKaKaKababaKababaKababaKab
aaajajajamajamajajajaaababababababaKabaKababaKababaKaKaKaKab
aaajajajajajajajajajaaababababababaKababababaKababaKabaKabab
aaajajajajajajajajajaaabaKaKaKaKaKaKabaKaKababababababaKabab
aaajajajajajajajajajaaababababaKabaKababaKababababababababab
aaajajajajajajajajajahaKabababaKabaKaKaKaKaKaKaKaKaKaKaKabab
aaajajajajajajajajajahaKaKaKaKaKabaKababaKababababababaKabab
aaajajajaWajaWajajajaaababababababaKababaKaKababaKaKaKaKabab
aaaaaaaaaaaaaaaaaaaaaaababababababababababababababababababab
"}

(1,1,3) = {"
abababababababababababababababababababababababababababababab
abaKaKaKaKaKaKababababababababababababababababababababababab
abaKaKaKaKaKaKaKaKaKaKaKababababababababaKaKaKaKaKababababab
ababababaKaKaKaKaKaKaKaKaKaKaKaKaKaKaKaKaKaKaKaKaKababababab
abababababababaKaKaKaKaKaKabababababababaKaKaKaKaKababaKaKab
abababababababababaKaKaKaKaKaKababababababababaKaKaKabaKaKab
abababababababababaKaKaKaKaKaKababababababababaKaKaKabaKaKab
abababababababababababaKaKaKaKababababababababaKaKaKabaKaKab
ababababababababababababababaKababababababababaKaKaKababaKab
abababababababababababaXaYaKaKaKaKaKaXababababaKaKabababaKab
ababababababababababaZaZaZbabababaaZaZaZabababaKaKabababaKab
abababababababababaMaZbbbbbbbbbbbbbbbbaZbcababaKaKaKaKaKaKab
abababababababababaKaZbbbbbbbbbbbbbbbbaZaLababaKaKaKaKaKaKab
abaKaKaKaKaKaKaKaKaKbabbbbbbbbbbbbbbbbbaaKabababababaKababab
abaKabababababababaKbabbbbbbbbbbbbbbbbbaaKabababababaKaKaKab
abaKabababababababbdaZbbbbbbbbbbbbbbbbaZaKabababababaKaKaKab
abaKabababababababaMaZbbbbbbbbbbbbbbbbaZbcababababababaKaKab
abaKababababababababaZaZaZbabababaaZaZaZaKaKaKaKabababaKaKab
abaKabababababababababaUaTaKaKaKaKaKaUababababaKaKababababab
abaKabababababaKaKaKabaKabaKaKaKababababababababaKaKaKababab
abaKabababababaKabaKaKaKababaKaKaKabababababababababaKaKabab
abaKabababababaKababababababaKaKaKabababababababababaKaKabab
abaKabababababaKabababababababaKaKaKababababababababaKaKabab
abaKaKaKaKaKaKaKabababababababaKaKaKaKaKaKaKaKaKaKaKaKaKabab
abaKabababababaKabababababababaKaKaKaKaKaKaKaKaKaKaKaKaKabab
abaKabababababaKabababababababababababababababababababababab
abaKabababababaKabababababababababababababababababaKaKaKaKab
abaKabaKaKaKabaKaKaKaKaKaKaKaKaKaKaKaKaKaKaKaKaKaKaKaKaKaKab
abaKaKaKabaKaKaKabababababababababababababababababaKaKaKaKab
abababababababababababababababababababababababababababababab
"}

(1,1,4) = {"
bebebebebebebebebebebebebebebebebebebebebebebebebebebebebebe
bebebebebebebebebebebebebebebebebebebebebebebebebebebebebebe
bebebebebebebebebebebebebebebebebebebebebebebebebebebebebebe
bebebebebebebebebebebebebebebebebebebebebebebebebebebebebebe
bebebebebebebebebebebebebebebebebebebebebebebebebebebebebebe
bebebebebebebebebebebebebebebebebebebebebebebebebebebebebebe
bebebebebebebebebebebebebebebebebebebebebebebebebebebebebebe
bebebebebebebebebebebebebebebebebebebebebebebebebebebebebebe
bebebebebebebebebebebebebebebebebebebebebebebebebebebebebebe
bebebebebebebebebebebebebebebebebebebebebebebebebebebebebebe
bebebebebebebebebebebebebebebebebebebebebebebebebebebebebebe
bebebebebebebebebebebebebebebebebebebebebebebebebebebebebebe
bebebebebebebebebebebebebebebebebebebebebebebebebebebebebebe
bebebebebebebebebebebebebebebebebebebebebebebebebebebebebebe
bebebebebebebebebebebebebebebebebebebebebebebebebebebebebebe
bebebebebebebebebebebebebebebebebebebebebebebebebebebebebebe
bebebebebebebebebebebebebebebebebebebebebebebebebebebebebebe
bebebebebebebebebebebebebebebebebebebebebebebebebebebebebebe
bebebebebebebebebebebebebebebebebebebebebebebebebebebebebebe
bebebebebebebebebebebebebebebebebebebebebebebebebebebebebebe
bebebebebebebebebebebebebebebebebebebebebebebebebebebebebebe
bebebebebebebebebebebebebebebebebebebebebebebebebebebebebebe
bebebebebebebebebebebebebebebebebebebebebebebebebebebebebebe
bebebebebebebebebebebebebebebebebebebebebebebebebebebebebebe
bebebebebebebebebebebebebebebebebebebebebebebebebebebebebebe
bebebebebebebebebebebebebebebebebebebebebebebebebebebebebebe
bebebebebebebebebebebebebebebebebebebebebebebebebebebebebebe
bebebebebebebebebebebebebebebebebebebebebebebebebebebebebebe
bebebebebebebebebebebebebebebebebebebebebebebebebebebebebebe
bebebebebebebebebebebebebebebebebebebebebebebebebebebebebebe
"}

(1,1,5) = {"
bebebebebebebebebebebebebebebebebebebebebebebebebebebebebebe
bebebebebebebebebebebebebebebebebebebebebebebebebebebebebebe
bebebebebebebebebebebebebebebebebebebebebebebebebebebebebebe
bebebebebebebebebebebebebebebebebebebebebebebebebebebebebebe
bebebebebebebebebebebebebebebebebebebebebebebebebebebebebebe
bebebebebebebebebebebebebebebebebebebebebebebebebebebebebebe
bebebebebebebebebebebebebebebebebebebebebebebebebebebebebebe
bebebebebebebebebebebebebebebebebebebebebebebebebebebebebebe
bebebebebebebebebebebebebebebebebebebebebebebebebebebebebebe
bebebebebebebebebebebebebebebebebebebebebebebebebebebebebebe
bebebebebebebebebebebebebebebebebebebebebebebebebebebebebebe
bebebebebebebebebebebebebebebebebebebebebebebebebebebebebebe
bebebebebebebebebebebebebebebebebebebebebebebebebebebebebebe
bebebebebebebebebebebebebebebebebebebebebebebebebebebebebebe
bebebebebebebebebebebebebebebebebebebebebebebebebebebebebebe
bebebebebebebebebebebebebebebebebebebebebebebebebebebebebebe
bebebebebebebebebebebebebebebebebebebebebebebebebebebebebebe
bebebebebebebebebebebebebebebebebebebebebebebebebebebebebebe
bebebebebebebebebebebebebebebebebebebebebebebebebebebebebebe
bebebebebebebebebebebebebebebebebebebebebebebebebebebebebebe
bebebebebebebebebebebebebebebebebebebebebebebebebebebebebebe
bebebebebebebebebebebebebebebebebebebebebebebebebebebebebebe
bebebebebebebebebebebebebebebebebebebebebebebebebebebebebebe
bebebebebebebebebebebebebebebebebebebebebebebebebebebebebebe
bebebebebebebebebebebebebebebebebebebebebebebebebebebebebebe
bebebebebebebebebebebebebebebebebebebebebebebebebebebebebebe
bebebebebebebebebebebebebebebebebebebebebebebebebebebebebebe
bebebebebebebebebebebebebebebebebebebebebebebebebebebebebebe
bebebebebebebebebebebebebebebebebebebebebebebebebebebebebebe
bebebebebebebebebebebebebebebebebebebebebebebebebebebebebebe
"}
