"aa" = (/turf/wall/generic,/area/underground)
"ab" = (/turf/wall/rock,/area/underground)
"ac" = (/turf/floor/generic/wooden,/area/underground)
"ad" = (/obj/electricity/lightbulb/east,/turf/floor/generic/wooden,/area/underground)
"ae" = (/liquid/lava,/turf/floor/rock,/area/underground)
"af" = (/obj/electricity/lightbulb/west,/turf/floor/generic/wooden,/area/underground)
"ag" = (/obj/electricity/lightbulb,/turf/floor/generic/wooden,/area/underground)
"ah" = (/obj/electricity/machine/door,/turf/floor/generic/red,/area/underground)
"ai" = (/obj/electricity/lightbulb/north,/turf/floor/generic/red,/area/underground)
"aj" = (/turf/floor/generic/red,/area/underground)
"ak" = (/turf/wall/window,/area/underground)
"al" = (/obj/electricity/lightswitch/east,/turf/floor/generic/wooden,/area/underground)
"am" = (/obj/electricity/lightbulb,/turf/floor/generic/red,/area/underground)
"an" = (/obj/electricity/elevator/button/west,/turf/floor/generic/red,/area/underground)
"ao" = (/obj/electricity/provider/generator,/turf/floor/rock,/area/underground)
"ap" = (/turf/floor/rock,/area/underground)
"aq" = (/obj/electricity/machine/door,/turf/floor/generic/black,/area/underground)
"ar" = (/turf/wall/generic,/area/elevator)
"as" = (/obj/electricity/machine/door/elevator_door,/turf/floor/generic/black,/area/elevator)
"at" = (/obj/electricity/provider/extender,/turf/floor/rock,/area/underground)
"au" = (/turf/floor/generic/black,/area/underground)
"av" = (/turf/floor/generic/chess,/area/underground)
"aw" = (/obj/electricity/elevator/button/east,/turf/floor/generic/chess,/area/underground)
"ax" = (/turf/floor/generic/black,/area/elevator)
"ay" = (/obj/electricity/elevator/controls/north,/turf/floor/generic/black,/area/elevator)
"az" = (/obj/electricity/elevator/button/west,/turf/floor/generic/chess,/area/underground)
"aA" = (/obj/electricity/lightbulb,/turf/floor/generic/black,/area/underground)
"aB" = (/obj/electricity/lightbulb/west,/turf/floor/generic/chess,/area/underground)
"aC" = (/obj/electricity/lightbulb/east,/turf/floor/generic/chess,/area/underground)
"aD" = (/obj/electricity/lightbulb/west,/turf/floor/generic/black,/area/elevator)
"aE" = (/obj/electricity/lightbulb/east,/turf/floor/generic/black,/area/elevator)
"aF" = (/obj/electricity/machine/door,/turf/floor/generic/chess,/area/underground)
"aG" = (/liquid/lava,/turf/floor/generic/wooden,/area/underground)
"aH" = (/turf/floor/generic/white,/area/underground)
"aI" = (/obj/item/container/suitcase,/turf/floor/generic/wooden,/area/underground)
"aJ" = (/obj/electricity/provider/extender,/turf/floor/generic/red,/area/underground)
"aK" = (/obj/electricity/provider/generator,/turf/floor/generic/wooden,/area/underground)
"aL" = (/obj/item/ball,/turf/floor/generic/wooden,/area/underground)
"aM" = (/obj/electricity/provider/extender,/turf/floor/generic/wooden,/area/underground)
"aN" = (/obj/electricity/lightbulb/west,/turf/floor/generic/red,/area/underground)
"aO" = (/obj/electricity/lightbulb/east,/turf/floor/generic/red,/area/underground)
"aP" = (/obj/electricity/lightbulb/west,/turf/floor/generic/white,/area/underground)
"aQ" = (/liquid/water,/turf/floor/generic/wooden,/area/underground)
"aR" = (/obj/electricity/elevator/button/west,/turf/floor/rock,/area/underground)
"aS" = (/obj/electricity/lightbulb/east,/turf/floor/rock,/area/underground)
"aT" = (/turf/wall/generic,/area/elevator{name = "Elevator0"})
"aU" = (/obj/electricity/machine/door/elevator_door,/turf/floor/generic/black,/area/elevator{name = "Elevator0"})
"aV" = (/turf/floor/generic/black,/area/elevator{name = "Elevator0"})
"aW" = (/obj/electricity/lightbulb/north,/turf/floor/generic/chess,/area/underground)
"aX" = (/obj/electricity/elevator/button/east,/turf/floor/generic/red,/area/underground)
"aY" = (/obj/electricity/lightbulb/south,/turf/floor/generic/chess,/area/underground)
"aZ" = (/obj/electricity/elevator/button/north,/turf/floor/rock,/area/underground)
"ba" = (/obj/electricity/lightbulb/north,/turf/floor/rock,/area/underground)
"bb" = (/obj/electricity/lightbulb,/turf/floor/rock,/area/underground)
"bc" = (/obj/electricity/lightbulb/south,/turf/floor/generic/red,/area/underground)
"bd" = (/obj/electricity/lightbulb/south,/turf/floor/rock,/area/underground)
"be" = (/obj/electricity/elevator/button/south,/turf/floor/rock,/area/underground)
"bf" = (/turf/wall/generic,/area/elevator{name = "Elevator1"})
"bg" = (/obj/electricity/machine/door/elevator_door,/turf/floor/generic/black,/area/elevator{name = "Elevator1"})
"bh" = (/turf/floor/generic/black,/area/elevator{name = "Elevator1"})
"bi" = (/obj/electricity/lightbulb/west,/turf/floor/rock,/area/underground)
"bj" = (/obj/electricity/elevator/button/east,/turf/floor/rock,/area/underground)
"bk" = (/turf,/area/underground)

(1,1,1) = {"
aaaaaaaaaaaaaaaaaaaaaaaaaaaaaaababababababababababababababab
aaacacacacacacacacacacacacadaaabaeaeaeaeaeaeaeaeaeaeaeaeaeab
aaafacacacacacacacacacacacadaaababababaeaeaeaeaeaeaeaeaeaeab
aaacacacacacagacacacacadaaaaaaaaaaaaabaeaeaeaeaeaeaeaeaeaeab
aaacacacacacacacacacacacahaiajajaiahakaeaeaeaeaeaeaeaeaeaeab
aaacacacacacacacacacacacahajajajajahakaeaeaeaeaeaeaeaeaeaeab
aaacacacacacacacacacacacahajajajajahakaeaeaeaeaeaeaeaeaeaeab
aaacacacacacagacacacacalaaajajajajababaeaeaeaeaeaeaeaeaeaeab
aaafacacacacacacacacacadaaamajajamaaabaeaeaeaeaeaeaeaeaeaeab
aaacacacacacacacacacacacaaanajajajaaabababababaoapabababakab
aaaqaaaaaaaaaaaaaaaaarararasasasasarararaaaaaaapataaaaaaaqaa
aaauaaavavavavavavawaraxayaxaxaxaxaxaxarazavavavavavavaaauaa
aaaAaaaBavavavavavaCaraDaxaxaxaxaxaxaEaraBavavavavavavaaaAaa
aaauaFavavavavavavavasaxaxaxaxaxaxaxaxasavavavavavavavaFauaa
aaauaaaBavavavavavavasaxaxaxaxaxaxaxaxasavavavavavavavaaauaa
aaaAakavavavavavavaCaraDaxaxaxaxaxaxaEaraBavavavavavavakaAaa
aaauakavavavavavavavaraxaxaxaxaxaxaxaxaravavavavavavavakauaa
aaaqaaaaaaaaaaaaaaaaarararasasasasarararaaaaaaaaaaaaaaaaaqaa
aaacacacacacacacacakacaGaaanajajajaaaHaHaHaHaHaHaHaHaHaHaHaa
aaacacacacacaIacacakacacaaajajajaJaaaHaHaHaHaHaHaHaHaHaHaHaa
aaacacacacacacacacaaaKacakajajajajakaHaHaHaHaHaHaHaHaHaHaHaa
aaacacacagacaLacagacacaMaaaNajajaOaaaPaHaHaHaHaHaHaHaHaHaHaa
aaacacacacacacaIacacacacakajajajajakaHaHaHaHaHaHaHaHaHaHaHaa
aaacacacacacacacacacacadaaaNajajaOaaaPaHaHaHaHaHaHaHaHaHaHaa
aaacacacacacacacacacacacakajajajajakaHaHaHaHaHaHaHaHaHaHaHaa
aaacacacagacacacagacacacaaajajajajaaaHaHaHaHaHaHaHaHaHaHaHaa
aaacacacacacacacacacacacahajajajajahaHaHaHaHaHaHaHaHaHaHaHaa
aaacacacacacacacacacacacahajajajajahaHaHaHaHaHaHaHaHaHaHaHaa
aaaQacacacacacacacacacacahajajajajahaHaHaHaHaHaHaHaHaHaHaHaa
aaaaaaaaaaaaaaaaaaaaaaaaaaaaaaaaaaaaaaaaaaaaaaaaaaaaaaaaaaaa
"}

(1,1,2) = {"
abababababababababababababababababababababababababababababab
ababababababababababababababababapapapapapababababababababab
abababababababababababababababapapapabapapapabababababababab
abababababababababababababababapapapababapapapababababababab
ababababababababababababababababapapapababapapapapapapapabab
abababababababababababababababababapapapabababababababapabab
abababababababababababababababababababababababababababapabab
ababapapapapapapapapapapapapapapapapapapapapapapapapapapabab
ababapapapapapapapapapapapapapapapapapapapapapapapapapapabab
ababapapabababababababababaRapapaSabababababababababapapabab
aaaaahahaaaaaaaaaaaaaTaTaTaUaUaUaUaTaTaTaaaaaaaaaaaaaFaFaaaa
aaajajajajajajajajajaTaVaVaVaVaVaVaVaVaTavavavaWavaWavavavaa
aaajajajajajajajajaXaTaVaVaVaVaVaVaVaVaTazavavavavavavavavaa
aaajajajajajajajajajaUaVaVaVaVaVaVaVaVaUavavavavavavavavavaa
aaajajajamajamajajajaUaVaVaVaVaVaVaVaVaUavavavavavavavavavaa
aaajajajajajajajajajaTaVaVaVaVaVaVaVaVaTavavavavavavavavavaa
aaajajajajajajajajajaTaVaVaVaVaVaVaVaVaTavavavaYavaYavavavaa
aaajajajajajajajajajaTaTaTaUaUaUaUaTaTaTaaaaaaaaaaaaaFaFaaaa
aaajajajajajajajajajaaabaZapabababababababababababababapbaab
aaajajajajajajajajajaaababbbapapapapapapapapapapapapababapab
aaajajajajajajajajajaaababababababababapababapababapababapab
aaajajajajajajajajajaaabapapapapapapapapababapababapababapab
aaajajajamajamajajajaaababababababapabapababapababapapapapab
aaajajajajajajajajajaaababababababapababababapababapabapabab
aaajajajajajajajajajaaabapapapapapapabapapababababababapabab
aaajajajajajajajajajaaababababapabapababapababababababababab
aaajajajajajajajajajahapabababapabapapapapapapapapapapapabab
aaajajajajajajajajajahapapapapapabapababapababababababapabab
aaajajajbcajbcajajajaaababababababapababapapababapapapapabab
aaaaaaaaaaaaaaaaaaaaaaababababababababababababababababababab
"}

(1,1,3) = {"
abababababababababababababababababababababababababababababab
abapapapapapapababababababababababababababababababababababab
abapapapapapapapapapapapababababababababapapapapapababababab
ababababapapapapapapapapapapapapapapapapapapapapapababababab
abababababababapapapapapapabababababababapapapapapababapapab
abababababababababapapapapapapababababababababapapapabapapab
abababababababababapapapapapapababababababababapapapabapapab
abababababababababababapapapapababababababababapapapabapapab
ababababababababababababababapababababababababapapapababapab
abababababababababababbdbeapapapapapbdababababapapabababapab
ababababababababababbfbfbfbgbgbgbgbfbfbfabababapapabababapab
abababababababababaSbfbhbhbhbhbhbhbhbhbfbiababapapapapapapab
abababababababababapbfbhbhbhbhbhbhbhbhbfaRababapapapapapapab
abapapapapapapapapapbgbhbhbhbhbhbhbhbhbgapabababababapababab
abapabababababababapbgbhbhbhbhbhbhbhbhbgapabababababapapapab
abapabababababababbjbfbhbhbhbhbhbhbhbhbfapabababababapapapab
abapabababababababaSbfbhbhbhbhbhbhbhbhbfbiababababababapapab
abapababababababababbfbfbfbgbgbgbgbfbfbfapapapapabababapapab
abapabababababababababbaaZapapapapapbaababababapapababababab
abapabababababapapapabapabapapapababababababababapapapababab
abapabababababapabapapapababapapapabababababababababapapabab
abapabababababapababababababapapapabababababababababapapabab
abapabababababapabababababababapapapababababababababapapabab
abapapapapapapapabababababababapapapapapapapapapapapapapabab
abapabababababapabababababababapapapapapapapapapapapapapabab
abapabababababapabababababababababababababababababababababab
abapabababababapabababababababababababababababababapapapapab
abapabapapapabapapapapapapapapapapapapapapapapapapapapapapab
abapapapabapapapabababababababababababababababababapapapapab
abababababababababababababababababababababababababababababab
"}

(1,1,4) = {"
bkbkbkbkbkbkbkbkbkbkbkbkbkbkbkbkbkbkbkbkbkbkbkbkbkbkbkbkbkbk
bkbkbkbkbkbkbkbkbkbkbkbkbkbkbkbkbkbkbkbkbkbkbkbkbkbkbkbkbkbk
bkbkbkbkbkbkbkbkbkbkbkbkbkbkbkbkbkbkbkbkbkbkbkbkbkbkbkbkbkbk
bkbkbkbkbkbkbkbkbkbkbkbkbkbkbkbkbkbkbkbkbkbkbkbkbkbkbkbkbkbk
bkbkbkbkbkbkbkbkbkbkbkbkbkbkbkbkbkbkbkbkbkbkbkbkbkbkbkbkbkbk
bkbkbkbkbkbkbkbkbkbkbkbkbkbkbkbkbkbkbkbkbkbkbkbkbkbkbkbkbkbk
bkbkbkbkbkbkbkbkbkbkbkbkbkbkbkbkbkbkbkbkbkbkbkbkbkbkbkbkbkbk
bkbkbkbkbkbkbkbkbkbkbkbkbkbkbkbkbkbkbkbkbkbkbkbkbkbkbkbkbkbk
bkbkbkbkbkbkbkbkbkbkbkbkbkbkbkbkbkbkbkbkbkbkbkbkbkbkbkbkbkbk
bkbkbkbkbkbkbkbkbkbkbkbkbkbkbkbkbkbkbkbkbkbkbkbkbkbkbkbkbkbk
bkbkbkbkbkbkbkbkbkbkbkbkbkbkbkbkbkbkbkbkbkbkbkbkbkbkbkbkbkbk
bkbkbkbkbkbkbkbkbkbkbkbkbkbkbkbkbkbkbkbkbkbkbkbkbkbkbkbkbkbk
bkbkbkbkbkbkbkbkbkbkbkbkbkbkbkbkbkbkbkbkbkbkbkbkbkbkbkbkbkbk
bkbkbkbkbkbkbkbkbkbkbkbkbkbkbkbkbkbkbkbkbkbkbkbkbkbkbkbkbkbk
bkbkbkbkbkbkbkbkbkbkbkbkbkbkbkbkbkbkbkbkbkbkbkbkbkbkbkbkbkbk
bkbkbkbkbkbkbkbkbkbkbkbkbkbkbkbkbkbkbkbkbkbkbkbkbkbkbkbkbkbk
bkbkbkbkbkbkbkbkbkbkbkbkbkbkbkbkbkbkbkbkbkbkbkbkbkbkbkbkbkbk
bkbkbkbkbkbkbkbkbkbkbkbkbkbkbkbkbkbkbkbkbkbkbkbkbkbkbkbkbkbk
bkbkbkbkbkbkbkbkbkbkbkbkbkbkbkbkbkbkbkbkbkbkbkbkbkbkbkbkbkbk
bkbkbkbkbkbkbkbkbkbkbkbkbkbkbkbkbkbkbkbkbkbkbkbkbkbkbkbkbkbk
bkbkbkbkbkbkbkbkbkbkbkbkbkbkbkbkbkbkbkbkbkbkbkbkbkbkbkbkbkbk
bkbkbkbkbkbkbkbkbkbkbkbkbkbkbkbkbkbkbkbkbkbkbkbkbkbkbkbkbkbk
bkbkbkbkbkbkbkbkbkbkbkbkbkbkbkbkbkbkbkbkbkbkbkbkbkbkbkbkbkbk
bkbkbkbkbkbkbkbkbkbkbkbkbkbkbkbkbkbkbkbkbkbkbkbkbkbkbkbkbkbk
bkbkbkbkbkbkbkbkbkbkbkbkbkbkbkbkbkbkbkbkbkbkbkbkbkbkbkbkbkbk
bkbkbkbkbkbkbkbkbkbkbkbkbkbkbkbkbkbkbkbkbkbkbkbkbkbkbkbkbkbk
bkbkbkbkbkbkbkbkbkbkbkbkbkbkbkbkbkbkbkbkbkbkbkbkbkbkbkbkbkbk
bkbkbkbkbkbkbkbkbkbkbkbkbkbkbkbkbkbkbkbkbkbkbkbkbkbkbkbkbkbk
bkbkbkbkbkbkbkbkbkbkbkbkbkbkbkbkbkbkbkbkbkbkbkbkbkbkbkbkbkbk
bkbkbkbkbkbkbkbkbkbkbkbkbkbkbkbkbkbkbkbkbkbkbkbkbkbkbkbkbkbk
"}

(1,1,5) = {"
bkbkbkbkbkbkbkbkbkbkbkbkbkbkbkbkbkbkbkbkbkbkbkbkbkbkbkbkbkbk
bkbkbkbkbkbkbkbkbkbkbkbkbkbkbkbkbkbkbkbkbkbkbkbkbkbkbkbkbkbk
bkbkbkbkbkbkbkbkbkbkbkbkbkbkbkbkbkbkbkbkbkbkbkbkbkbkbkbkbkbk
bkbkbkbkbkbkbkbkbkbkbkbkbkbkbkbkbkbkbkbkbkbkbkbkbkbkbkbkbkbk
bkbkbkbkbkbkbkbkbkbkbkbkbkbkbkbkbkbkbkbkbkbkbkbkbkbkbkbkbkbk
bkbkbkbkbkbkbkbkbkbkbkbkbkbkbkbkbkbkbkbkbkbkbkbkbkbkbkbkbkbk
bkbkbkbkbkbkbkbkbkbkbkbkbkbkbkbkbkbkbkbkbkbkbkbkbkbkbkbkbkbk
bkbkbkbkbkbkbkbkbkbkbkbkbkbkbkbkbkbkbkbkbkbkbkbkbkbkbkbkbkbk
bkbkbkbkbkbkbkbkbkbkbkbkbkbkbkbkbkbkbkbkbkbkbkbkbkbkbkbkbkbk
bkbkbkbkbkbkbkbkbkbkbkbkbkbkbkbkbkbkbkbkbkbkbkbkbkbkbkbkbkbk
bkbkbkbkbkbkbkbkbkbkbkbkbkbkbkbkbkbkbkbkbkbkbkbkbkbkbkbkbkbk
bkbkbkbkbkbkbkbkbkbkbkbkbkbkbkbkbkbkbkbkbkbkbkbkbkbkbkbkbkbk
bkbkbkbkbkbkbkbkbkbkbkbkbkbkbkbkbkbkbkbkbkbkbkbkbkbkbkbkbkbk
bkbkbkbkbkbkbkbkbkbkbkbkbkbkbkbkbkbkbkbkbkbkbkbkbkbkbkbkbkbk
bkbkbkbkbkbkbkbkbkbkbkbkbkbkbkbkbkbkbkbkbkbkbkbkbkbkbkbkbkbk
bkbkbkbkbkbkbkbkbkbkbkbkbkbkbkbkbkbkbkbkbkbkbkbkbkbkbkbkbkbk
bkbkbkbkbkbkbkbkbkbkbkbkbkbkbkbkbkbkbkbkbkbkbkbkbkbkbkbkbkbk
bkbkbkbkbkbkbkbkbkbkbkbkbkbkbkbkbkbkbkbkbkbkbkbkbkbkbkbkbkbk
bkbkbkbkbkbkbkbkbkbkbkbkbkbkbkbkbkbkbkbkbkbkbkbkbkbkbkbkbkbk
bkbkbkbkbkbkbkbkbkbkbkbkbkbkbkbkbkbkbkbkbkbkbkbkbkbkbkbkbkbk
bkbkbkbkbkbkbkbkbkbkbkbkbkbkbkbkbkbkbkbkbkbkbkbkbkbkbkbkbkbk
bkbkbkbkbkbkbkbkbkbkbkbkbkbkbkbkbkbkbkbkbkbkbkbkbkbkbkbkbkbk
bkbkbkbkbkbkbkbkbkbkbkbkbkbkbkbkbkbkbkbkbkbkbkbkbkbkbkbkbkbk
bkbkbkbkbkbkbkbkbkbkbkbkbkbkbkbkbkbkbkbkbkbkbkbkbkbkbkbkbkbk
bkbkbkbkbkbkbkbkbkbkbkbkbkbkbkbkbkbkbkbkbkbkbkbkbkbkbkbkbkbk
bkbkbkbkbkbkbkbkbkbkbkbkbkbkbkbkbkbkbkbkbkbkbkbkbkbkbkbkbkbk
bkbkbkbkbkbkbkbkbkbkbkbkbkbkbkbkbkbkbkbkbkbkbkbkbkbkbkbkbkbk
bkbkbkbkbkbkbkbkbkbkbkbkbkbkbkbkbkbkbkbkbkbkbkbkbkbkbkbkbkbk
bkbkbkbkbkbkbkbkbkbkbkbkbkbkbkbkbkbkbkbkbkbkbkbkbkbkbkbkbkbk
bkbkbkbkbkbkbkbkbkbkbkbkbkbkbkbkbkbkbkbkbkbkbkbkbkbkbkbkbkbk
"}
