"aa" = (/turf/wall/generic,/area/underground)
"ab" = (/turf/wall/rock,/area/underground)
"ac" = (/turf/floor/generic/wooden,/area/underground)
"ad" = (/obj/electricity/lightbulb/east,/turf/floor/generic/wooden,/area/underground)
"ae" = (/liquid/lava,/turf/floor/rock,/area/underground)
"af" = (/obj/electricity/lightbulb/west,/turf/floor/generic/wooden,/area/underground)
"ag" = (/obj/electricity/lightbulb,/turf/floor/generic/wooden,/area/underground)
"ah" = (/obj/electricity/machine/door,/turf/floor/generic/red,/area/underground)
"ai" = (/obj/electricity/lightbulb/north,/turf/floor/generic/red,/area/underground)
"aj" = (/turf/floor/generic/red,/area/underground)
"ak" = (/turf/wall/window,/area/underground)
"al" = (/obj/electricity/lightswitch/east,/turf/floor/generic/wooden,/area/underground)
"am" = (/obj/electricity/lightbulb,/turf/floor/generic/red,/area/underground)
"an" = (/obj/electricity/elevator/button/west,/turf/floor/generic/red,/area/underground)
"ao" = (/obj/electricity/provider/generator,/turf/floor/rock,/area/underground)
"ap" = (/turf/floor/rock,/area/underground)
"aq" = (/obj/electricity/machine/door,/turf/floor/generic/black,/area/underground)
"ar" = (/turf/wall/generic,/area/lab/elevator)
"as" = (/obj/electricity/machine/door/elevator_door,/turf/floor/generic/black,/area/lab/elevator)
"at" = (/obj/electricity/provider/extender,/turf/floor/rock,/area/underground)
"au" = (/turf/floor/generic/black,/area/underground)
"av" = (/turf/floor/generic/chess,/area/underground)
"aw" = (/obj/electricity/elevator/button/east,/turf/floor/generic/chess,/area/underground)
"ax" = (/turf/floor/generic/black,/area/lab/elevator)
"ay" = (/obj/electricity/elevator/controls/north,/turf/floor/generic/black,/area/lab/elevator)
"az" = (/obj/electricity/elevator/button/west,/turf/floor/generic/chess,/area/underground)
"aA" = (/obj/electricity/lightbulb,/turf/floor/generic/black,/area/underground)
"aB" = (/obj/electricity/lightbulb/west,/turf/floor/generic/chess,/area/underground)
"aC" = (/obj/electricity/lightbulb/east,/turf/floor/generic/chess,/area/underground)
"aD" = (/obj/electricity/lightbulb/west,/turf/floor/generic/black,/area/lab/elevator)
"aE" = (/obj/electricity/lightbulb/east,/turf/floor/generic/black,/area/lab/elevator)
"aF" = (/obj/electricity/machine/door,/turf/floor/generic/chess,/area/underground)
"aG" = (/turf/floor/generic/white,/area/underground)
"aH" = (/obj/item/container/suitcase,/turf/floor/generic/wooden,/area/underground)
"aI" = (/obj/item/ball,/turf/floor/generic/wooden,/area/underground)
"aJ" = (/obj/electricity/lightbulb/west,/turf/floor/generic/red,/area/underground)
"aK" = (/obj/electricity/lightbulb/east,/turf/floor/generic/red,/area/underground)
"aL" = (/obj/electricity/lightbulb/west,/turf/floor/generic/white,/area/underground)
"aM" = (/liquid/lava,/turf/floor/generic/white,/area/underground)
"aN" = (/liquid/water,/turf/floor/generic/wooden,/area/underground)
"aO" = (/obj/electricity/elevator/button/west,/turf/floor/rock,/area/underground)
"aP" = (/obj/electricity/lightbulb/east,/turf/floor/rock,/area/underground)
"aQ" = (/turf/wall/generic,/area/lab/elevator{name = "Elevator0"})
"aR" = (/obj/electricity/machine/door/elevator_door,/turf/floor/generic/black,/area/lab/elevator{name = "Elevator0"})
"aS" = (/turf/floor/generic/black,/area/lab/elevator{name = "Elevator0"})
"aT" = (/obj/electricity/lightbulb/north,/turf/floor/generic/chess,/area/underground)
"aU" = (/obj/electricity/elevator/button/east,/turf/floor/generic/red,/area/underground)
"aV" = (/obj/electricity/lightbulb/south,/turf/floor/generic/chess,/area/underground)
"aW" = (/obj/electricity/elevator/button/north,/turf/floor/rock,/area/underground)
"aX" = (/obj/electricity/lightbulb/north,/turf/floor/rock,/area/underground)
"aY" = (/obj/electricity/lightbulb,/turf/floor/rock,/area/underground)
"aZ" = (/obj/electricity/lightbulb/south,/turf/floor/generic/red,/area/underground)
"ba" = (/obj/electricity/lightbulb/south,/turf/floor/rock,/area/underground)
"bb" = (/obj/electricity/elevator/button/south,/turf/floor/rock,/area/underground)
"bc" = (/turf/wall/generic,/area/lab/elevator{name = "Elevator1"})
"bd" = (/obj/electricity/machine/door/elevator_door,/turf/floor/generic/black,/area/lab/elevator{name = "Elevator1"})
"be" = (/turf/floor/generic/black,/area/lab/elevator{name = "Elevator1"})
"bf" = (/obj/electricity/lightbulb/west,/turf/floor/rock,/area/underground)
"bg" = (/obj/electricity/elevator/button/east,/turf/floor/rock,/area/underground)
"bh" = (/turf,/area/underground)

(1,1,1) = {"
aaaaaaaaaaaaaaaaaaaaaaaaaaaaaaababababababababababababababab
aaacacacacacacacacacacacacadaaabaeaeaeaeaeaeaeaeaeaeaeaeaeab
aaafacacacacacacacacacacacadaaababababaeaeaeaeaeaeaeaeaeaeab
aaacacacacacagacacacacadaaaaaaaaaaaaabaeaeaeaeaeaeaeaeaeaeab
aaacacacacacacacacacacacahaiajajaiahakaeaeaeaeaeaeaeaeaeaeab
aaacacacacacacacacacacacahajajajajahakaeaeaeaeaeaeaeaeaeaeab
aaacacacacacacacacacacacahajajajajahakaeaeaeaeaeaeaeaeaeaeab
aaacacacacacagacacacacalaaajajajajababaeaeaeaeaeaeaeaeaeaeab
aaafacacacacacacacacacadaaamajajamaaabaeaeaeaeaeaeaeaeaeaeab
aaacacacacacacacacacacacaaanajajajaaabababababaoapabababakab
aaaqaaaaaaaaaaaaaaaaarararasasasasarararaaaaaaapataaaaaaaqaa
aaauaaavavavavavavawaraxayaxaxaxaxaxaxarazavavavavavavaaauaa
aaaAaaaBavavavavavaCaraDaxaxaxaxaxaxaEaraBavavavavavavaaaAaa
aaauaFavavavavavavavasaxaxaxaxaxaxaxaxasavavavavavavavaFauaa
aaauaaaBavavavavavavasaxaxaxaxaxaxaxaxasavavavavavavavaaauaa
aaaAakavavavavavavaCaraDaxaxaxaxaxaxaEaraBavavavavavavakaAaa
aaauakavavavavavavavaraxaxaxaxaxaxaxaxaravavavavavavavakauaa
aaaqaaaaaaaaaaaaaaaaarararasasasasarararaaaaaaaaaaaaaaaaaqaa
aaacacacacacacacacacacacaaanajajajaaaGaGaGaGaGaGaGaGaGaGaGaa
aaacacacacacaHacacacacacaaajajajajaaaGaGaGaGaGaGaGaGaGaGaGaa
aaacacacacacacacaIacacacakajajajajakaGaGaGaGaGaGaGaGaGaGaGaa
aaacacacagacaIaIagacacadaaaJajajaKaaaLaGaGaGaGaGaGaGaGaGaGaa
aaacacacacacacaHacacacacakajajajajakaGaGaGaGaGaGaGaGaGaGaGaa
aaacacacacacacacacacacadaaaJajajaKaaaLaGaGaGaGaMaGaGaGaGaGaa
aaacacacacacacacacacacacakajajajajakaGaGaGaGaGaGaGaGaGaGaGaa
aaacacacagacacacagacacacaaajajajajaaaGaGaGaGaGaGaGaGaGaGaGaa
aaacacacacacacacacacacacahajajajajahaGaGaGaGaGaGaGaGaGaGaGaa
aaacacacacacacacacacacacahajajajajahaGaGaGaGaGaGaGaGaGaGaGaa
aaaNacacacacacacacacacacahajajajajahaGaGaGaGaGaGaGaGaGaGaGaa
aaaaaaaaaaaaaaaaaaaaaaaaaaaaaaaaaaaaaaaaaaaaaaaaaaaaaaaaaaaa
"}

(1,1,2) = {"
abababababababababababababababababababababababababababababab
ababababababababababababababababapapapapapababababababababab
abababababababababababababababapapapabapapapabababababababab
abababababababababababababababapapapababapapapababababababab
ababababababababababababababababapapapababapapapapapapapabab
abababababababababababababababababapapapabababababababapabab
abababababababababababababababababababababababababababapabab
ababapapapapapapapapapapapapapapapapapapapapapapapapapapabab
ababapapapapapapapapapapapapapapapapapapapapapapapapapapabab
ababapapabababababababababaOapapaPabababababababababapapabab
aaaaahahaaaaaaaaaaaaaQaQaQaRaRaRaRaQaQaQaaaaaaaaaaaaaFaFaaaa
aaajajajajajajajajajaQaSaSaSaSaSaSaSaSaQavavavaTavaTavavavaa
aaajajajajajajajajaUaQaSaSaSaSaSaSaSaSaQazavavavavavavavavaa
aaajajajajajajajajajaRaSaSaSaSaSaSaSaSaRavavavavavavavavavaa
aaajajajamajamajajajaRaSaSaSaSaSaSaSaSaRavavavavavavavavavaa
aaajajajajajajajajajaQaSaSaSaSaSaSaSaSaQavavavavavavavavavaa
aaajajajajajajajajajaQaSaSaSaSaSaSaSaSaQavavavaVavaVavavavaa
aaajajajajajajajajajaQaQaQaRaRaRaRaQaQaQaaaaaaaaaaaaaFaFaaaa
aaajajajajajajajajajaaabaWapabababababababababababababapaXab
aaajajajajajajajajajaaababaYapapapapapapapapapapapapababapab
aaajajajajajajajajajaaababababababababapababapababapababapab
aaajajajajajajajajajaaabapapapapapapapapababapababapababapab
aaajajajamajamajajajaaababababababapabapababapababapapapapab
aaajajajajajajajajajaaababababababapababababapababapabapabab
aaajajajajajajajajajaaabapapapapapapabapapababababababapabab
aaajajajajajajajajajaaababababapabapababapababababababababab
aaajajajajajajajajajahapabababapabapapapapapapapapapapapabab
aaajajajajajajajajajahapapapapapabapababapababababababapabab
aaajajajaZajaZajajajaaababababababapababapapababapapapapabab
aaaaaaaaaaaaaaaaaaaaaaababababababababababababababababababab
"}

(1,1,3) = {"
abababababababababababababababababababababababababababababab
abapapapapapapababababababababababababababababababababababab
abapapapapapapapapapapapababababababababapapapapapababababab
ababababapapapapapapapapapapapapapapapapapapapapapababababab
abababababababapapapapapapabababababababapapapapapababapapab
abababababababababapapapapapapababababababababapapapabapapab
abababababababababapapapapapapababababababababapapapabapapab
abababababababababababapapapapababababababababapapapabapapab
ababababababababababababababapababababababababapapapababapab
abababababababababababbabbapapapapapbaababababapapabababapab
ababababababababababbcbcbcbdbdbdbdbcbcbcabababapapabababapab
abababababababababaPbcbebebebebebebebebcbfababapapapapapapab
abababababababababapbcbebebebebebebebebcaOababapapapapapapab
abapapapapapapapapapbdbebebebebebebebebdapabababababapababab
abapabababababababapbdbebebebebebebebebdapabababababapapapab
abapabababababababbgbcbebebebebebebebebcapabababababapapapab
abapabababababababaPbcbebebebebebebebebcbfababababababapapab
abapababababababababbcbcbcbdbdbdbdbcbcbcapapapapabababapapab
abapabababababababababaXaWapapapapapaXababababapapababababab
abapabababababapapapabapabapapapababababababababapapapababab
abapabababababapabapapapababapapapabababababababababapapabab
abapabababababapababababababapapapabababababababababapapabab
abapabababababapabababababababapapapababababababababapapabab
abapapapapapapapabababababababapapapapapapapapapapapapapabab
abapabababababapabababababababapapapapapapapapapapapapapabab
abapabababababapabababababababababababababababababababababab
abapabababababapabababababababababababababababababapapapapab
abapabapapapabapapapapapapapapapapapapapapapapapapapapapapab
abapapapabapapapabababababababababababababababababapapapapab
abababababababababababababababababababababababababababababab
"}

(1,1,4) = {"
bhbhbhbhbhbhbhbhbhbhbhbhbhbhbhbhbhbhbhbhbhbhbhbhbhbhbhbhbhbh
bhbhbhbhbhbhbhbhbhbhbhbhbhbhbhbhbhbhbhbhbhbhbhbhbhbhbhbhbhbh
bhbhbhbhbhbhbhbhbhbhbhbhbhbhbhbhbhbhbhbhbhbhbhbhbhbhbhbhbhbh
bhbhbhbhbhbhbhbhbhbhbhbhbhbhbhbhbhbhbhbhbhbhbhbhbhbhbhbhbhbh
bhbhbhbhbhbhbhbhbhbhbhbhbhbhbhbhbhbhbhbhbhbhbhbhbhbhbhbhbhbh
bhbhbhbhbhbhbhbhbhbhbhbhbhbhbhbhbhbhbhbhbhbhbhbhbhbhbhbhbhbh
bhbhbhbhbhbhbhbhbhbhbhbhbhbhbhbhbhbhbhbhbhbhbhbhbhbhbhbhbhbh
bhbhbhbhbhbhbhbhbhbhbhbhbhbhbhbhbhbhbhbhbhbhbhbhbhbhbhbhbhbh
bhbhbhbhbhbhbhbhbhbhbhbhbhbhbhbhbhbhbhbhbhbhbhbhbhbhbhbhbhbh
bhbhbhbhbhbhbhbhbhbhbhbhbhbhbhbhbhbhbhbhbhbhbhbhbhbhbhbhbhbh
bhbhbhbhbhbhbhbhbhbhbhbhbhbhbhbhbhbhbhbhbhbhbhbhbhbhbhbhbhbh
bhbhbhbhbhbhbhbhbhbhbhbhbhbhbhbhbhbhbhbhbhbhbhbhbhbhbhbhbhbh
bhbhbhbhbhbhbhbhbhbhbhbhbhbhbhbhbhbhbhbhbhbhbhbhbhbhbhbhbhbh
bhbhbhbhbhbhbhbhbhbhbhbhbhbhbhbhbhbhbhbhbhbhbhbhbhbhbhbhbhbh
bhbhbhbhbhbhbhbhbhbhbhbhbhbhbhbhbhbhbhbhbhbhbhbhbhbhbhbhbhbh
bhbhbhbhbhbhbhbhbhbhbhbhbhbhbhbhbhbhbhbhbhbhbhbhbhbhbhbhbhbh
bhbhbhbhbhbhbhbhbhbhbhbhbhbhbhbhbhbhbhbhbhbhbhbhbhbhbhbhbhbh
bhbhbhbhbhbhbhbhbhbhbhbhbhbhbhbhbhbhbhbhbhbhbhbhbhbhbhbhbhbh
bhbhbhbhbhbhbhbhbhbhbhbhbhbhbhbhbhbhbhbhbhbhbhbhbhbhbhbhbhbh
bhbhbhbhbhbhbhbhbhbhbhbhbhbhbhbhbhbhbhbhbhbhbhbhbhbhbhbhbhbh
bhbhbhbhbhbhbhbhbhbhbhbhbhbhbhbhbhbhbhbhbhbhbhbhbhbhbhbhbhbh
bhbhbhbhbhbhbhbhbhbhbhbhbhbhbhbhbhbhbhbhbhbhbhbhbhbhbhbhbhbh
bhbhbhbhbhbhbhbhbhbhbhbhbhbhbhbhbhbhbhbhbhbhbhbhbhbhbhbhbhbh
bhbhbhbhbhbhbhbhbhbhbhbhbhbhbhbhbhbhbhbhbhbhbhbhbhbhbhbhbhbh
bhbhbhbhbhbhbhbhbhbhbhbhbhbhbhbhbhbhbhbhbhbhbhbhbhbhbhbhbhbh
bhbhbhbhbhbhbhbhbhbhbhbhbhbhbhbhbhbhbhbhbhbhbhbhbhbhbhbhbhbh
bhbhbhbhbhbhbhbhbhbhbhbhbhbhbhbhbhbhbhbhbhbhbhbhbhbhbhbhbhbh
bhbhbhbhbhbhbhbhbhbhbhbhbhbhbhbhbhbhbhbhbhbhbhbhbhbhbhbhbhbh
bhbhbhbhbhbhbhbhbhbhbhbhbhbhbhbhbhbhbhbhbhbhbhbhbhbhbhbhbhbh
bhbhbhbhbhbhbhbhbhbhbhbhbhbhbhbhbhbhbhbhbhbhbhbhbhbhbhbhbhbh
"}

(1,1,5) = {"
bhbhbhbhbhbhbhbhbhbhbhbhbhbhbhbhbhbhbhbhbhbhbhbhbhbhbhbhbhbh
bhbhbhbhbhbhbhbhbhbhbhbhbhbhbhbhbhbhbhbhbhbhbhbhbhbhbhbhbhbh
bhbhbhbhbhbhbhbhbhbhbhbhbhbhbhbhbhbhbhbhbhbhbhbhbhbhbhbhbhbh
bhbhbhbhbhbhbhbhbhbhbhbhbhbhbhbhbhbhbhbhbhbhbhbhbhbhbhbhbhbh
bhbhbhbhbhbhbhbhbhbhbhbhbhbhbhbhbhbhbhbhbhbhbhbhbhbhbhbhbhbh
bhbhbhbhbhbhbhbhbhbhbhbhbhbhbhbhbhbhbhbhbhbhbhbhbhbhbhbhbhbh
bhbhbhbhbhbhbhbhbhbhbhbhbhbhbhbhbhbhbhbhbhbhbhbhbhbhbhbhbhbh
bhbhbhbhbhbhbhbhbhbhbhbhbhbhbhbhbhbhbhbhbhbhbhbhbhbhbhbhbhbh
bhbhbhbhbhbhbhbhbhbhbhbhbhbhbhbhbhbhbhbhbhbhbhbhbhbhbhbhbhbh
bhbhbhbhbhbhbhbhbhbhbhbhbhbhbhbhbhbhbhbhbhbhbhbhbhbhbhbhbhbh
bhbhbhbhbhbhbhbhbhbhbhbhbhbhbhbhbhbhbhbhbhbhbhbhbhbhbhbhbhbh
bhbhbhbhbhbhbhbhbhbhbhbhbhbhbhbhbhbhbhbhbhbhbhbhbhbhbhbhbhbh
bhbhbhbhbhbhbhbhbhbhbhbhbhbhbhbhbhbhbhbhbhbhbhbhbhbhbhbhbhbh
bhbhbhbhbhbhbhbhbhbhbhbhbhbhbhbhbhbhbhbhbhbhbhbhbhbhbhbhbhbh
bhbhbhbhbhbhbhbhbhbhbhbhbhbhbhbhbhbhbhbhbhbhbhbhbhbhbhbhbhbh
bhbhbhbhbhbhbhbhbhbhbhbhbhbhbhbhbhbhbhbhbhbhbhbhbhbhbhbhbhbh
bhbhbhbhbhbhbhbhbhbhbhbhbhbhbhbhbhbhbhbhbhbhbhbhbhbhbhbhbhbh
bhbhbhbhbhbhbhbhbhbhbhbhbhbhbhbhbhbhbhbhbhbhbhbhbhbhbhbhbhbh
bhbhbhbhbhbhbhbhbhbhbhbhbhbhbhbhbhbhbhbhbhbhbhbhbhbhbhbhbhbh
bhbhbhbhbhbhbhbhbhbhbhbhbhbhbhbhbhbhbhbhbhbhbhbhbhbhbhbhbhbh
bhbhbhbhbhbhbhbhbhbhbhbhbhbhbhbhbhbhbhbhbhbhbhbhbhbhbhbhbhbh
bhbhbhbhbhbhbhbhbhbhbhbhbhbhbhbhbhbhbhbhbhbhbhbhbhbhbhbhbhbh
bhbhbhbhbhbhbhbhbhbhbhbhbhbhbhbhbhbhbhbhbhbhbhbhbhbhbhbhbhbh
bhbhbhbhbhbhbhbhbhbhbhbhbhbhbhbhbhbhbhbhbhbhbhbhbhbhbhbhbhbh
bhbhbhbhbhbhbhbhbhbhbhbhbhbhbhbhbhbhbhbhbhbhbhbhbhbhbhbhbhbh
bhbhbhbhbhbhbhbhbhbhbhbhbhbhbhbhbhbhbhbhbhbhbhbhbhbhbhbhbhbh
bhbhbhbhbhbhbhbhbhbhbhbhbhbhbhbhbhbhbhbhbhbhbhbhbhbhbhbhbhbh
bhbhbhbhbhbhbhbhbhbhbhbhbhbhbhbhbhbhbhbhbhbhbhbhbhbhbhbhbhbh
bhbhbhbhbhbhbhbhbhbhbhbhbhbhbhbhbhbhbhbhbhbhbhbhbhbhbhbhbhbh
bhbhbhbhbhbhbhbhbhbhbhbhbhbhbhbhbhbhbhbhbhbhbhbhbhbhbhbhbhbh
"}
