"aa" = (/turf/wall/generic,/area/underground)
"ab" = (/turf/floor/generic/wooden,/area/underground)
"ac" = (/obj/electricity/lightbulb/east,/turf/floor/generic/wooden,/area/underground)
"ad" = (/turf/floor/generic/white,/area/underground)
"ae" = (/obj/electricity/lightbulb/west,/turf/floor/generic/wooden,/area/underground)
"af" = (/obj/electricity/lightbulb,/turf/floor/generic/wooden,/area/underground)
"ag" = (/obj/electricity/machine/door,/turf/floor/generic/red,/area/underground)
"ah" = (/obj/electricity/lightbulb/north,/turf/floor/generic/red,/area/underground)
"ai" = (/turf/floor/generic/red,/area/underground)
"aj" = (/obj/electricity/lightswitch/east,/turf/floor/generic/wooden,/area/underground)
"ak" = (/obj/electricity/lightbulb,/turf/floor/generic/red,/area/underground)
"al" = (/obj/electricity/elevator/button/west,/turf/floor/generic/red,/area/underground)
"am" = (/obj/electricity/machine/door,/turf/floor/generic/black,/area/underground)
"an" = (/turf/wall/generic,/area/elevator)
"ao" = (/obj/electricity/machine/door/elevator_door,/turf/floor/generic/black,/area/elevator)
"ap" = (/turf/floor/generic/black,/area/underground)
"aq" = (/turf/floor/generic/chess,/area/underground)
"ar" = (/obj/electricity/elevator/button/east,/turf/floor/generic/chess,/area/underground)
"as" = (/turf/floor/generic/black,/area/elevator)
"at" = (/obj/electricity/elevator/controls/north,/turf/floor/generic/black,/area/elevator)
"au" = (/obj/electricity/elevator/button/west,/turf/floor/generic/chess,/area/underground)
"av" = (/obj/electricity/lightbulb,/turf/floor/generic/black,/area/underground)
"aw" = (/obj/electricity/lightbulb/west,/turf/floor/generic/chess,/area/underground)
"ax" = (/obj/electricity/lightbulb/east,/turf/floor/generic/chess,/area/underground)
"ay" = (/obj/electricity/lightbulb/west,/turf/floor/generic/black,/area/elevator)
"az" = (/obj/electricity/lightbulb/east,/turf/floor/generic/black,/area/elevator)
"aA" = (/obj/electricity/machine/door,/turf/floor/generic/chess,/area/underground)
"aB" = (/liquid/lava,/turf/floor/generic/wooden,/area/underground)
"aC" = (/obj/item/ball,/turf/floor/generic/wooden,/area/underground)
"aD" = (/liquid/water,/turf/floor/generic/wooden,/area/underground)
"aE" = (/turf/wall/rock,/area/underground)
"aF" = (/turf/floor/rock,/area/underground)
"aG" = (/obj/electricity/elevator/button/west,/turf/floor/rock,/area/underground)
"aH" = (/obj/electricity/lightbulb/east,/turf/floor/rock,/area/underground)
"aI" = (/turf/wall/generic,/area/elevator{name = "Elevator0"})
"aJ" = (/obj/electricity/machine/door/elevator_door,/turf/floor/generic/black,/area/elevator{name = "Elevator0"})
"aK" = (/turf/floor/generic/black,/area/elevator{name = "Elevator0"})
"aL" = (/obj/electricity/lightbulb/north,/turf/floor/generic/chess,/area/underground)
"aM" = (/obj/electricity/elevator/button/east,/turf/floor/generic/red,/area/underground)
"aN" = (/obj/electricity/lightbulb/south,/turf/floor/generic/chess,/area/underground)
"aO" = (/obj/electricity/elevator/button/north,/turf/floor/rock,/area/underground)
"aP" = (/obj/electricity/lightbulb/north,/turf/floor/rock,/area/underground)
"aQ" = (/obj/electricity/lightbulb,/turf/floor/rock,/area/underground)
"aR" = (/obj/electricity/lightbulb/south,/turf/floor/generic/red,/area/underground)
"aS" = (/obj/electricity/lightbulb/south,/turf/floor/rock,/area/underground)
"aT" = (/obj/electricity/elevator/button/south,/turf/floor/rock,/area/underground)
"aU" = (/turf/wall/generic,/area/elevator{name = "Elevator1"})
"aV" = (/obj/electricity/machine/door/elevator_door,/turf/floor/generic/black,/area/elevator{name = "Elevator1"})
"aW" = (/turf/floor/generic/black,/area/elevator{name = "Elevator1"})
"aX" = (/obj/electricity/lightbulb/west,/turf/floor/rock,/area/underground)
"aY" = (/obj/electricity/elevator/button/east,/turf/floor/rock,/area/underground)
"aZ" = (/turf,/area/underground)

(1,1,1) = {"
aaaaaaaaaaaaaaaaaaaaaaaaaaaaaaaaaaaaaaaaaaaaaaaaaaaaaaaaaaaa
aaababababababababababababacaaaaadadadadadadadadadadadadadaa
aaaeabababababababababababacaaaaadadadadadadadadadadadadadaa
aaabababababafababababacaaaaaaaaaaaaadadadadadadadadadadadaa
aaabababababababababababagahaiaiahagadadadadadadadadadadadaa
aaabababababababababababagaiaiaiaiagadadadadadadadadadadadaa
aaabababababababababababagaiaiaiaiagadadadadadadadadadadadaa
aaabababababafababababajaaaiaiaiaiaaadadadadadadadadadadadaa
aaaeabababababababababacaaakaiaiakaaadadadadadadadadadadadaa
aaabababababababababababaaalaiaiaiaaadadadadadadadadadadadaa
aaamaaaaaaaaaaaaaaaaanananaoaoaoaoanananaaaaaaaaaaaaaaaaamaa
aaapaaaqaqaqaqaqaqaranasatasasasasasasanauaqaqaqaqaqaqaaapaa
aaavaaawaqaqaqaqaqaxanayasasasasasasazanawaqaqaqaqaqaqaaavaa
aaapaAaqaqaqaqaqaqaqaoasasasasasasasasaoaqaqaqaqaqaqaqaAapaa
aaapaaawaqaqaqaqaqaqaoasasasasasasasasaoaqaqaqaqaqaqaqaaapaa
aaavaaaqaqaqaqaqaqaxanayasasasasasasazanawaqaqaqaqaqaqaaavaa
aaapaaaqaqaqaqaqaqaqanasasasasasasasasanaqaqaqaqaqaqaqaaapaa
aaamaaaaaaaaaaaaaaaaanananaoaoaoaoanananaaaaaaaaaaaaaaaaamaa
aaababababababababababaBaaalaiaiaiaaadadadadadadadadadadadaa
aaabababababababababababaaaiaiaiaiaaadadadadadadadadadadadaa
aaabababababababababababaaaiaiaiaiaaadadadadadadadadadadadaa
aaabababafabaCabafabababaaaiaiaiaiaaadadadadadadadadadadadaa
aaabababababababababababaaaiaiaiaiaaadadadadadadadadadadadaa
aaabababababababababababaaaiaiaiaiaaadadadadadadadadadadadaa
aaabababababababababababaaaiaiaiaiaaadadadadadadadadadadadaa
aaabababafabababafabababaaaiaiaiaiaaadadadadadadadadadadadaa
aaabababababababababababagaiaiaiaiagadadadadadadadadadadadaa
aaabababababababababababagaiaiaiaiagadadadadadadadadadadadaa
aaaDababababababababababagaiaiaiaiagadadadadadadadadadadadaa
aaaaaaaaaaaaaaaaaaaaaaaaaaaaaaaaaaaaaaaaaaaaaaaaaaaaaaaaaaaa
"}

(1,1,2) = {"
aEaEaEaEaEaEaEaEaEaEaEaEaEaEaEaEaEaEaEaEaEaEaEaEaEaEaEaEaEaE
aEaEaEaEaEaEaEaEaEaEaEaEaEaEaEaEaFaFaFaFaFaEaEaEaEaEaEaEaEaE
aEaEaEaEaEaEaEaEaEaEaEaEaEaEaEaFaFaFaEaFaFaFaEaEaEaEaEaEaEaE
aEaEaEaEaEaEaEaEaEaEaEaEaEaEaEaFaFaFaEaEaFaFaFaEaEaEaEaEaEaE
aEaEaEaEaEaEaEaEaEaEaEaEaEaEaEaEaFaFaFaEaEaFaFaFaFaFaFaFaEaE
aEaEaEaEaEaEaEaEaEaEaEaEaEaEaEaEaEaFaFaFaEaEaEaEaEaEaEaFaEaE
aEaEaEaEaEaEaEaEaEaEaEaEaEaEaEaEaEaEaEaEaEaEaEaEaEaEaEaFaEaE
aEaEaFaFaFaFaFaFaFaFaFaFaFaFaFaFaFaFaFaFaFaFaFaFaFaFaFaFaEaE
aEaEaFaFaFaFaFaFaFaFaFaFaFaFaFaFaFaFaFaFaFaFaFaFaFaFaFaFaEaE
aEaEaFaFaEaEaEaEaEaEaEaEaEaGaFaFaHaEaEaEaEaEaEaEaEaEaFaFaEaE
aaaaagagaaaaaaaaaaaaaIaIaIaJaJaJaJaIaIaIaaaaaaaaaaaaaAaAaaaa
aaaiaiaiaiaiaiaiaiaiaIaKaKaKaKaKaKaKaKaIaqaqaqaLaqaLaqaqaqaa
aaaiaiaiaiaiaiaiaiaMaIaKaKaKaKaKaKaKaKaIauaqaqaqaqaqaqaqaqaa
aaaiaiaiaiaiaiaiaiaiaJaKaKaKaKaKaKaKaKaJaqaqaqaqaqaqaqaqaqaa
aaaiaiaiakaiakaiaiaiaJaKaKaKaKaKaKaKaKaJaqaqaqaqaqaqaqaqaqaa
aaaiaiaiaiaiaiaiaiaiaIaKaKaKaKaKaKaKaKaIaqaqaqaqaqaqaqaqaqaa
aaaiaiaiaiaiaiaiaiaiaIaKaKaKaKaKaKaKaKaIaqaqaqaNaqaNaqaqaqaa
aaaiaiaiaiaiaiaiaiaiaIaIaIaJaJaJaJaIaIaIaaaaaaaaaaaaaAaAaaaa
aaaiaiaiaiaiaiaiaiaiaaaEaOaFaEaEaEaEaEaEaEaEaEaEaEaEaEaFaPaE
aaaiaiaiaiaiaiaiaiaiaaaEaEaQaFaFaFaFaFaFaFaFaFaFaFaFaEaEaFaE
aaaiaiaiaiaiaiaiaiaiaaaEaEaEaEaEaEaEaEaFaEaEaFaEaEaFaEaEaFaE
aaaiaiaiaiaiaiaiaiaiaaaEaFaFaFaFaFaFaFaFaEaEaFaEaEaFaEaEaFaE
aaaiaiaiakaiakaiaiaiaaaEaEaEaEaEaEaFaEaFaEaEaFaEaEaFaFaFaFaE
aaaiaiaiaiaiaiaiaiaiaaaEaEaEaEaEaEaFaEaEaEaEaFaEaEaFaEaFaEaE
aaaiaiaiaiaiaiaiaiaiaaaEaFaFaFaFaFaFaEaFaFaEaEaEaEaEaEaFaEaE
aaaiaiaiaiaiaiaiaiaiaaaEaEaEaEaFaEaFaEaEaFaEaEaEaEaEaEaEaEaE
aaaiaiaiaiaiaiaiaiaiagaFaEaEaEaFaEaFaFaFaFaFaFaFaFaFaFaFaEaE
aaaiaiaiaiaiaiaiaiaiagaFaFaFaFaFaEaFaEaEaFaEaEaEaEaEaEaFaEaE
aaaiaiaiaRaiaRaiaiaiaaaEaEaEaEaEaEaFaEaEaFaFaEaEaFaFaFaFaEaE
aaaaaaaaaaaaaaaaaaaaaaaEaEaEaEaEaEaEaEaEaEaEaEaEaEaEaEaEaEaE
"}

(1,1,3) = {"
aEaEaEaEaEaEaEaEaEaEaEaEaEaEaEaEaEaEaEaEaEaEaEaEaEaEaEaEaEaE
aEaFaFaFaFaFaFaEaEaEaEaEaEaEaEaEaEaEaEaEaEaEaEaEaEaEaEaEaEaE
aEaFaFaFaFaFaFaFaFaFaFaFaEaEaEaEaEaEaEaEaFaFaFaFaFaEaEaEaEaE
aEaEaEaEaFaFaFaFaFaFaFaFaFaFaFaFaFaFaFaFaFaFaFaFaFaEaEaEaEaE
aEaEaEaEaEaEaEaFaFaFaFaFaFaEaEaEaEaEaEaEaFaFaFaFaFaEaEaFaFaE
aEaEaEaEaEaEaEaEaEaFaFaFaFaFaFaEaEaEaEaEaEaEaEaFaFaFaEaFaFaE
aEaEaEaEaEaEaEaEaEaFaFaFaFaFaFaEaEaEaEaEaEaEaEaFaFaFaEaFaFaE
aEaEaEaEaEaEaEaEaEaEaEaFaFaFaFaEaEaEaEaEaEaEaEaFaFaFaEaFaFaE
aEaEaEaEaEaEaEaEaEaEaEaEaEaEaFaEaEaEaEaEaEaEaEaFaFaFaEaEaFaE
aEaEaEaEaEaEaEaEaEaEaEaSaTaFaFaFaFaFaSaEaEaEaEaFaFaEaEaEaFaE
aEaEaEaEaEaEaEaEaEaEaUaUaUaVaVaVaVaUaUaUaEaEaEaFaFaEaEaEaFaE
aEaEaEaEaEaEaEaEaEaHaUaWaWaWaWaWaWaWaWaUaXaEaEaFaFaFaFaFaFaE
aEaEaEaEaEaEaEaEaEaFaUaWaWaWaWaWaWaWaWaUaGaEaEaFaFaFaFaFaFaE
aEaFaFaFaFaFaFaFaFaFaVaWaWaWaWaWaWaWaWaVaFaEaEaEaEaEaFaEaEaE
aEaFaEaEaEaEaEaEaEaFaVaWaWaWaWaWaWaWaWaVaFaEaEaEaEaEaFaFaFaE
aEaFaEaEaEaEaEaEaEaYaUaWaWaWaWaWaWaWaWaUaFaEaEaEaEaEaFaFaFaE
aEaFaEaEaEaEaEaEaEaHaUaWaWaWaWaWaWaWaWaUaXaEaEaEaEaEaEaFaFaE
aEaFaEaEaEaEaEaEaEaEaUaUaUaVaVaVaVaUaUaUaFaFaFaFaEaEaEaFaFaE
aEaFaEaEaEaEaEaEaEaEaEaPaOaFaFaFaFaFaPaEaEaEaEaFaFaEaEaEaEaE
aEaFaEaEaEaEaEaFaFaFaEaFaEaFaFaFaEaEaEaEaEaEaEaEaFaFaFaEaEaE
aEaFaEaEaEaEaEaFaEaFaFaFaEaEaFaFaFaEaEaEaEaEaEaEaEaEaFaFaEaE
aEaFaEaEaEaEaEaFaEaEaEaEaEaEaFaFaFaEaEaEaEaEaEaEaEaEaFaFaEaE
aEaFaEaEaEaEaEaFaEaEaEaEaEaEaEaFaFaFaEaEaEaEaEaEaEaEaFaFaEaE
aEaFaFaFaFaFaFaFaEaEaEaEaEaEaEaFaFaFaFaFaFaFaFaFaFaFaFaFaEaE
aEaFaEaEaEaEaEaFaEaEaEaEaEaEaEaFaFaFaFaFaFaFaFaFaFaFaFaFaEaE
aEaFaEaEaEaEaEaFaEaEaEaEaEaEaEaEaEaEaEaEaEaEaEaEaEaEaEaEaEaE
aEaFaEaEaEaEaEaFaEaEaEaEaEaEaEaEaEaEaEaEaEaEaEaEaEaFaFaFaFaE
aEaFaEaFaFaFaEaFaFaFaFaFaFaFaFaFaFaFaFaFaFaFaFaFaFaFaFaFaFaE
aEaFaFaFaEaFaFaFaEaEaEaEaEaEaEaEaEaEaEaEaEaEaEaEaEaFaFaFaFaE
aEaEaEaEaEaEaEaEaEaEaEaEaEaEaEaEaEaEaEaEaEaEaEaEaEaEaEaEaEaE
"}

(1,1,4) = {"
aZaZaZaZaZaZaZaZaZaZaZaZaZaZaZaZaZaZaZaZaZaZaZaZaZaZaZaZaZaZ
aZaZaZaZaZaZaZaZaZaZaZaZaZaZaZaZaZaZaZaZaZaZaZaZaZaZaZaZaZaZ
aZaZaZaZaZaZaZaZaZaZaZaZaZaZaZaZaZaZaZaZaZaZaZaZaZaZaZaZaZaZ
aZaZaZaZaZaZaZaZaZaZaZaZaZaZaZaZaZaZaZaZaZaZaZaZaZaZaZaZaZaZ
aZaZaZaZaZaZaZaZaZaZaZaZaZaZaZaZaZaZaZaZaZaZaZaZaZaZaZaZaZaZ
aZaZaZaZaZaZaZaZaZaZaZaZaZaZaZaZaZaZaZaZaZaZaZaZaZaZaZaZaZaZ
aZaZaZaZaZaZaZaZaZaZaZaZaZaZaZaZaZaZaZaZaZaZaZaZaZaZaZaZaZaZ
aZaZaZaZaZaZaZaZaZaZaZaZaZaZaZaZaZaZaZaZaZaZaZaZaZaZaZaZaZaZ
aZaZaZaZaZaZaZaZaZaZaZaZaZaZaZaZaZaZaZaZaZaZaZaZaZaZaZaZaZaZ
aZaZaZaZaZaZaZaZaZaZaZaZaZaZaZaZaZaZaZaZaZaZaZaZaZaZaZaZaZaZ
aZaZaZaZaZaZaZaZaZaZaZaZaZaZaZaZaZaZaZaZaZaZaZaZaZaZaZaZaZaZ
aZaZaZaZaZaZaZaZaZaZaZaZaZaZaZaZaZaZaZaZaZaZaZaZaZaZaZaZaZaZ
aZaZaZaZaZaZaZaZaZaZaZaZaZaZaZaZaZaZaZaZaZaZaZaZaZaZaZaZaZaZ
aZaZaZaZaZaZaZaZaZaZaZaZaZaZaZaZaZaZaZaZaZaZaZaZaZaZaZaZaZaZ
aZaZaZaZaZaZaZaZaZaZaZaZaZaZaZaZaZaZaZaZaZaZaZaZaZaZaZaZaZaZ
aZaZaZaZaZaZaZaZaZaZaZaZaZaZaZaZaZaZaZaZaZaZaZaZaZaZaZaZaZaZ
aZaZaZaZaZaZaZaZaZaZaZaZaZaZaZaZaZaZaZaZaZaZaZaZaZaZaZaZaZaZ
aZaZaZaZaZaZaZaZaZaZaZaZaZaZaZaZaZaZaZaZaZaZaZaZaZaZaZaZaZaZ
aZaZaZaZaZaZaZaZaZaZaZaZaZaZaZaZaZaZaZaZaZaZaZaZaZaZaZaZaZaZ
aZaZaZaZaZaZaZaZaZaZaZaZaZaZaZaZaZaZaZaZaZaZaZaZaZaZaZaZaZaZ
aZaZaZaZaZaZaZaZaZaZaZaZaZaZaZaZaZaZaZaZaZaZaZaZaZaZaZaZaZaZ
aZaZaZaZaZaZaZaZaZaZaZaZaZaZaZaZaZaZaZaZaZaZaZaZaZaZaZaZaZaZ
aZaZaZaZaZaZaZaZaZaZaZaZaZaZaZaZaZaZaZaZaZaZaZaZaZaZaZaZaZaZ
aZaZaZaZaZaZaZaZaZaZaZaZaZaZaZaZaZaZaZaZaZaZaZaZaZaZaZaZaZaZ
aZaZaZaZaZaZaZaZaZaZaZaZaZaZaZaZaZaZaZaZaZaZaZaZaZaZaZaZaZaZ
aZaZaZaZaZaZaZaZaZaZaZaZaZaZaZaZaZaZaZaZaZaZaZaZaZaZaZaZaZaZ
aZaZaZaZaZaZaZaZaZaZaZaZaZaZaZaZaZaZaZaZaZaZaZaZaZaZaZaZaZaZ
aZaZaZaZaZaZaZaZaZaZaZaZaZaZaZaZaZaZaZaZaZaZaZaZaZaZaZaZaZaZ
aZaZaZaZaZaZaZaZaZaZaZaZaZaZaZaZaZaZaZaZaZaZaZaZaZaZaZaZaZaZ
aZaZaZaZaZaZaZaZaZaZaZaZaZaZaZaZaZaZaZaZaZaZaZaZaZaZaZaZaZaZ
"}

(1,1,5) = {"
aZaZaZaZaZaZaZaZaZaZaZaZaZaZaZaZaZaZaZaZaZaZaZaZaZaZaZaZaZaZ
aZaZaZaZaZaZaZaZaZaZaZaZaZaZaZaZaZaZaZaZaZaZaZaZaZaZaZaZaZaZ
aZaZaZaZaZaZaZaZaZaZaZaZaZaZaZaZaZaZaZaZaZaZaZaZaZaZaZaZaZaZ
aZaZaZaZaZaZaZaZaZaZaZaZaZaZaZaZaZaZaZaZaZaZaZaZaZaZaZaZaZaZ
aZaZaZaZaZaZaZaZaZaZaZaZaZaZaZaZaZaZaZaZaZaZaZaZaZaZaZaZaZaZ
aZaZaZaZaZaZaZaZaZaZaZaZaZaZaZaZaZaZaZaZaZaZaZaZaZaZaZaZaZaZ
aZaZaZaZaZaZaZaZaZaZaZaZaZaZaZaZaZaZaZaZaZaZaZaZaZaZaZaZaZaZ
aZaZaZaZaZaZaZaZaZaZaZaZaZaZaZaZaZaZaZaZaZaZaZaZaZaZaZaZaZaZ
aZaZaZaZaZaZaZaZaZaZaZaZaZaZaZaZaZaZaZaZaZaZaZaZaZaZaZaZaZaZ
aZaZaZaZaZaZaZaZaZaZaZaZaZaZaZaZaZaZaZaZaZaZaZaZaZaZaZaZaZaZ
aZaZaZaZaZaZaZaZaZaZaZaZaZaZaZaZaZaZaZaZaZaZaZaZaZaZaZaZaZaZ
aZaZaZaZaZaZaZaZaZaZaZaZaZaZaZaZaZaZaZaZaZaZaZaZaZaZaZaZaZaZ
aZaZaZaZaZaZaZaZaZaZaZaZaZaZaZaZaZaZaZaZaZaZaZaZaZaZaZaZaZaZ
aZaZaZaZaZaZaZaZaZaZaZaZaZaZaZaZaZaZaZaZaZaZaZaZaZaZaZaZaZaZ
aZaZaZaZaZaZaZaZaZaZaZaZaZaZaZaZaZaZaZaZaZaZaZaZaZaZaZaZaZaZ
aZaZaZaZaZaZaZaZaZaZaZaZaZaZaZaZaZaZaZaZaZaZaZaZaZaZaZaZaZaZ
aZaZaZaZaZaZaZaZaZaZaZaZaZaZaZaZaZaZaZaZaZaZaZaZaZaZaZaZaZaZ
aZaZaZaZaZaZaZaZaZaZaZaZaZaZaZaZaZaZaZaZaZaZaZaZaZaZaZaZaZaZ
aZaZaZaZaZaZaZaZaZaZaZaZaZaZaZaZaZaZaZaZaZaZaZaZaZaZaZaZaZaZ
aZaZaZaZaZaZaZaZaZaZaZaZaZaZaZaZaZaZaZaZaZaZaZaZaZaZaZaZaZaZ
aZaZaZaZaZaZaZaZaZaZaZaZaZaZaZaZaZaZaZaZaZaZaZaZaZaZaZaZaZaZ
aZaZaZaZaZaZaZaZaZaZaZaZaZaZaZaZaZaZaZaZaZaZaZaZaZaZaZaZaZaZ
aZaZaZaZaZaZaZaZaZaZaZaZaZaZaZaZaZaZaZaZaZaZaZaZaZaZaZaZaZaZ
aZaZaZaZaZaZaZaZaZaZaZaZaZaZaZaZaZaZaZaZaZaZaZaZaZaZaZaZaZaZ
aZaZaZaZaZaZaZaZaZaZaZaZaZaZaZaZaZaZaZaZaZaZaZaZaZaZaZaZaZaZ
aZaZaZaZaZaZaZaZaZaZaZaZaZaZaZaZaZaZaZaZaZaZaZaZaZaZaZaZaZaZ
aZaZaZaZaZaZaZaZaZaZaZaZaZaZaZaZaZaZaZaZaZaZaZaZaZaZaZaZaZaZ
aZaZaZaZaZaZaZaZaZaZaZaZaZaZaZaZaZaZaZaZaZaZaZaZaZaZaZaZaZaZ
aZaZaZaZaZaZaZaZaZaZaZaZaZaZaZaZaZaZaZaZaZaZaZaZaZaZaZaZaZaZ
aZaZaZaZaZaZaZaZaZaZaZaZaZaZaZaZaZaZaZaZaZaZaZaZaZaZaZaZaZaZ
"}
