"aa" = (/turf/wall/generic,/area/underground)
"ab" = (/turf/wall/rock,/area/underground)
"ac" = (/turf/floor/generic/wooden,/area/underground)
"ad" = (/obj/electricity/lightbulb/east,/turf/floor/generic/wooden,/area/underground)
"ae" = (/liquid/lava,/turf/floor/rock,/area/underground)
"af" = (/obj/electricity/lightbulb/west,/turf/floor/generic/wooden,/area/underground)
"ag" = (/obj/electricity/lightbulb,/turf/floor/generic/wooden,/area/underground)
"ah" = (/obj/electricity/machine/door,/turf/floor/generic/red,/area/underground)
"ai" = (/obj/electricity/lightbulb/north,/turf/floor/generic/red,/area/underground)
"aj" = (/turf/floor/generic/red,/area/underground)
"ak" = (/turf/wall/window,/area/underground)
"al" = (/obj/electricity/lightswitch/east,/turf/floor/generic/wooden,/area/underground)
"am" = (/obj/electricity/lightbulb,/turf/floor/generic/red,/area/underground)
"an" = (/obj/electricity/elevator/button/west,/turf/floor/generic/red,/area/underground)
"ao" = (/obj/electricity/provider/generator,/turf/floor/rock,/area/underground)
"ap" = (/turf/floor/rock,/area/underground)
"aq" = (/obj/electricity/machine/door,/turf/floor/generic/black,/area/underground)
"ar" = (/turf/wall/generic,/area/lab/elevator)
"as" = (/obj/electricity/machine/door/elevator_door,/turf/floor/generic/black,/area/lab/elevator)
"at" = (/obj/electricity/provider/extender,/turf/floor/rock,/area/underground)
"au" = (/turf/floor/generic/black,/area/underground)
"av" = (/turf/floor/generic/chess,/area/underground)
"aw" = (/obj/electricity/elevator/button/east,/turf/floor/generic/chess,/area/underground)
"ax" = (/turf/floor/generic/black,/area/lab/elevator)
"ay" = (/obj/electricity/elevator/controls/north,/turf/floor/generic/black,/area/lab/elevator)
"az" = (/obj/electricity/elevator/button/west,/turf/floor/generic/chess,/area/underground)
"aA" = (/obj/electricity/lightbulb,/turf/floor/generic/black,/area/underground)
"aB" = (/obj/electricity/lightbulb/west,/turf/floor/generic/chess,/area/underground)
"aC" = (/obj/electricity/lightbulb/east,/turf/floor/generic/chess,/area/underground)
"aD" = (/obj/electricity/lightbulb/west,/turf/floor/generic/black,/area/lab/elevator)
"aE" = (/obj/electricity/lightbulb/east,/turf/floor/generic/black,/area/lab/elevator)
"aF" = (/obj/electricity/machine/door,/turf/floor/generic/chess,/area/underground)
"aG" = (/turf/floor/generic/white,/area/underground)
"aH" = (/obj/item/container/suitcase,/turf/floor/generic/wooden,/area/underground)
"aI" = (/obj/item/ball,/turf/floor/generic/wooden,/area/underground)
"aJ" = (/obj/electricity/lightbulb/west,/turf/floor/generic/red,/area/underground)
"aK" = (/obj/electricity/lightbulb/east,/turf/floor/generic/red,/area/underground)
"aL" = (/obj/electricity/lightbulb/west,/turf/floor/generic/white,/area/underground)
"aM" = (/obj/item/weapon/pickaxe,/turf/floor/generic/wooden,/area/underground)
"aN" = (/liquid/lava,/turf/floor/generic/white,/area/underground)
"aO" = (/liquid/water,/turf/floor/generic/wooden,/area/underground)
"aP" = (/obj/electricity/lightbulb/north,/turf/floor/rock,/area/underground)
"aQ" = (/obj/electricity/elevator/button/west,/turf/floor/rock,/area/underground)
"aR" = (/obj/electricity/lightbulb/east,/turf/floor/rock,/area/underground)
"aS" = (/turf/wall/generic,/area/lab/elevator{name = "Elevator0"})
"aT" = (/obj/electricity/machine/door/elevator_door,/turf/floor/generic/black,/area/lab/elevator{name = "Elevator0"})
"aU" = (/obj/electricity/provider/extender,/turf/floor/generic/white,/area/underground)
"aV" = (/turf/floor/generic/black,/area/lab/elevator{name = "Elevator0"})
"aW" = (/obj/electricity/elevator/button/east,/turf/floor/generic/red,/area/underground)
"aX" = (/obj/electricity/lightbulb/south,/turf/floor/generic/chess,/area/underground)
"aY" = (/obj/electricity/elevator/button/north,/turf/floor/rock,/area/underground)
"aZ" = (/obj/electricity/lightbulb,/turf/floor/rock,/area/underground)
"ba" = (/obj/electricity/lightbulb/south,/turf/floor/generic/red,/area/underground)
"bb" = (/obj/electricity/lightbulb/south,/turf/floor/rock,/area/underground)
"bc" = (/obj/electricity/elevator/button/south,/turf/floor/rock,/area/underground)
"bd" = (/turf/wall/generic,/area/lab/elevator{name = "Elevator1"})
"be" = (/obj/electricity/machine/door/elevator_door,/turf/floor/generic/black,/area/lab/elevator{name = "Elevator1"})
"bf" = (/turf/floor/generic/black,/area/lab/elevator{name = "Elevator1"})
"bg" = (/obj/electricity/elevator/button/west,/turf/floor/generic/white,/area/underground)
"bh" = (/obj/electricity/elevator/button/east,/turf/floor/rock,/area/underground)
"bi" = (/obj/electricity/machine/door,/turf/floor/generic/white,/area/underground)
"bj" = (/turf,/area/underground)

(1,1,1) = {"
aaaaaaaaaaaaaaaaaaaaaaaaaaaaaaababababababababababababababab
aaacacacacacacacacacacacacadaaabaeaeaeaeaeaeaeaeaeaeaeaeaeab
aaafacacacacacacacacacacacadaaababababaeaeaeaeaeaeaeaeaeaeab
aaacacacacacagacacacacadaaaaaaaaaaaaabaeaeaeaeaeaeaeaeaeaeab
aaacacacacacacacacacacacahaiajajaiahakaeaeaeaeaeaeaeaeaeaeab
aaacacacacacacacacacacacahajajajajahakaeaeaeaeaeaeaeaeaeaeab
aaacacacacacacacacacacacahajajajajahakaeaeaeaeaeaeaeaeaeaeab
aaacacacacacagacacacacalaaajajajajababaeaeaeaeaeaeaeaeaeaeab
aaafacacacacacacacacacadaaamajajamaaabaeaeaeaeaeaeaeaeaeaeab
aaacacacacacacacacacacacaaanajajajaaabababababaoapabababakab
aaaqaaaaaaaaaaaaaaaaarararasasasasarararaaaaaaatapaaaaaaaqaa
aaauaaavavavavavavawaraxayaxaxaxaxaxaxarazavavavavavavaaauaa
aaaAaaaBavavavavavaCaraDaxaxaxaxaxaxaEaraBavavavavavavaaaAaa
aaauaFavavavavavavavasaxaxaxaxaxaxaxaxasavavavavavavavaFauaa
aaauaaaBavavavavavavasaxaxaxaxaxaxaxaxasavavavavavavavaaauaa
aaaAakavavavavavavaCaraDaxaxaxaxaxaxaEaraBavavavavavavakaAaa
aaauakavavavavavavavaraxaxaxaxaxaxaxaxaravavavavavavavakauaa
aaaqaaaaaaaaaaaaaaaaarararasasasasarararaaaaaaaaaaaaaaaaaqaa
aaacacacacacacacacacacacaaanajajajaaaGaGaGaGaGaGaGaGaGaGaGaa
aaacacacacacaHacacacacacaaajajajajaaaGaGaGaGaGaGaGaGaGaGaGaa
aaacacacacacacacaIacacacakajajajajakaGaGaGaGaGaGaGaGaGaGaGaa
aaacacacagacaIaIagacacadaaaJajajaKaaaLaGaGaGaGaGaGaGaGaGaGaa
aaacacacacacacaHacacacacakajajajajakaGaGaGaGaGaGaGaGaGaGaGaa
aaacacacaMaMaMaMaMacacadaaaJajajaKaaaLaGaGaGaGaNaGaGaGaGaGaa
aaacacacaMaMaMaMaMacacacakajajajajakaGaGaGaGaGaGaGaGaGaGaGaa
aaacacacagacacacagacacacaaajajajajaaaGaGaGaGaGaGaGaGaGaGaGaa
aaacacacacacabacacacacacahajajajajahaGaGaGaGaGaGaGaGaGaGaGaa
aaacacacacacacacacacacacahajajajajahaGaGaGaGaGaGaGaGaGaGaGaa
aaaOacacacacacacacacacacahajajajajahaGaGaGaGaGaGaGaGaGaGaGaa
aaaaaaaaaaaaaaaaaaaaaaaaaaaaaaaaaaaaaaaaaaaaaaaaaaaaaaaaaaaa
"}

(1,1,2) = {"
abababababababababababababababababababababababababababababab
ababababababababababababababababapapapapapababababababababab
abababababababababababababababapapapabapapapabababababababab
abababababababababababababababapapapababapapapababababababab
ababababababababababababababababapapapababapapapapapapapabab
abababababababababababababababababapapapabababababababapabab
abababababababababababababababababababababababababababapabab
ababapapapapapapapapapapapapapapapapapapapapaPapaPapapapabab
ababapapapapapapapapapapapapapapapapapapapapapapapapapapabab
ababapapabababababababababaQapapaRabababababaaaaaaabapapabab
aaaaahahaaaaaaaaaaaaaSaSaSaTaTaTaTaSaSaSaaaaaaaUaaaaaFaFaaaa
aaajajajajajajajajajaSaVaVaVaVaVaVaVaVaSavavavavavavavavavaa
aaajajajajajajajajaWaSaVaVaVaVaVaVaVaVaSazavavavavavavavavaa
aaajajajajajajajajajaTaVaVaVaVaVaVaVaVaTavavavavavavavavavaa
aaajajajamajamajajajaTaVaVaVaVaVaVaVaVaTavavavavavavavavavaa
aaajajajajajajajajajaSaVaVaVaVaVaVaVaVaSavavavavavavavavavaa
aaajajajajajajajajajaSaVaVaVaVaVaVaVaVaSavavavaXavaXavavavaa
aaajajajajajajajajajaSaSaSaTaTaTaTaSaSaSaaaaaaaaaaaaaFaFaaaa
aaajajajajajajajajajaaabaYapabababababababababababababapaPab
aaajajajajajajajajajaaababaZapapapapapapapapapapapapababapab
aaajajajajajajajajajaaababababababababapababapababapababapab
aaajajajajajajajajajaaabapapapapapapapapababapababapababapab
aaajajajamajamajajajaaababababababapabapababapababapapapapab
aaajajajajajajajajajaaababababababapababababapababapabapabab
aaajajajajajajajajajaaabapapapapapapabapapababababababapabab
aaajajajajajajajajajaaababababapabapababapababababababababab
aaajajajajajajajajajahapabababapabapapapapapapapapapapapabab
aaajajajajajajajajajahapapapapapabapababapababababababapabab
aaajajajbaajbaajajajaaababababababapababapapababapapapapabab
aaaaaaaaaaaaaaaaaaaaaaababababababababababababababababababab
"}

(1,1,3) = {"
abababababababababababababababababababababababababababababab
abapapapapapapababababababababababababababababababababababab
abapapapapapapapapapapapababababababababapapapapapababababab
ababababapapapapapapapapapapapapapapapapapapapapapababababab
abababababababapapapapapapabababababababapapapapapababapapab
abababababababababapapapapapapababababababababapapapabapapab
abababababababababapapapapapapababababababababapapapabapapab
abababababababababababapapapapababababababababapapapabapapab
ababababababababababababababapababababababababapapapababapab
abababababababababababbbbcapapapapapbbaaaaaaaaakaaabababapab
ababababababababababbdbdbdbebebebebdbdbdaGaGaGaUakabababapab
abababababababababaRbdbfbfbfbfbfbfbfbfbdaLaaaaakaaapapapapab
abababababababababapbdbfbfbfbfbfbfbfbfbdbgaaabapapapapapapab
abapapapapapapapapapbebfbfbfbfbfbfbfbfbeaGaaababababapababab
abapabababababababapbebfbfbfbfbfbfbfbfbeaGaaababababapapapab
abapabababababababbhbdbfbfbfbfbfbfbfbfbdaGaaababababapapapab
abapabababababababaRbdbfbfbfbfbfbfbfbfbdaLaaabababababapapab
abapababababababababbdbdbdbebebebebdbdbdaGaaapapabababapapab
abapabababababababababaPaYapapapapapaPaabiaaabapapababababab
abapabababababapapapabapabapapapababapapapabababapapapababab
abapabababababapabapapapababapapapabababababababababapapabab
abapabababababapababababababapapapabababababababababapapabab
abapabababababapabababababababapapapababababababababapapabab
abapapapapapapapabababababababapapapapapapapapapapapapapabab
abapabababababapabababababababapapapapapapapapapapapapapabab
abapabababababapabababababababababababababababababababababab
abapabababababapabababababababababababababababababapapapapab
abapabapapapabapapapapapapapapapapapapapapapapapapapapapapab
abapapapabapapapabababababababababababababababababapapapapab
abababababababababababababababababababababababababababababab
"}

(1,1,4) = {"
bjbjbjbjbjbjbjbjbjbjbjbjbjbjbjbjbjbjbjbjbjbjbjbjbjbjbjbjbjbj
bjbjbjbjbjbjbjbjbjbjbjbjbjbjbjbjbjbjbjbjbjbjbjbjbjbjbjbjbjbj
bjbjbjbjbjbjbjbjbjbjbjbjbjbjbjbjbjbjbjbjbjbjbjbjbjbjbjbjbjbj
bjbjbjbjbjbjbjbjbjbjbjbjbjbjbjbjbjbjbjbjbjbjbjbjbjbjbjbjbjbj
bjbjbjbjbjbjbjbjbjbjbjbjbjbjbjbjbjbjbjbjbjbjbjbjbjbjbjbjbjbj
bjbjbjbjbjbjbjbjbjbjbjbjbjbjbjbjbjbjbjbjbjbjbjbjbjbjbjbjbjbj
bjbjbjbjbjbjbjbjbjbjbjbjbjbjbjbjbjbjbjbjbjbjbjbjbjbjbjbjbjbj
bjbjbjbjbjbjbjbjbjbjbjbjbjbjbjbjbjbjbjbjbjbjbjbjbjbjbjbjbjbj
bjbjbjbjbjbjbjbjbjbjbjbjbjbjbjbjbjbjbjbjbjbjbjbjbjbjbjbjbjbj
bjbjbjbjbjbjbjbjbjbjbjbjbjbjbjbjbjbjbjbjbjbjbjbjbjbjbjbjbjbj
bjbjbjbjbjbjbjbjbjbjbjbjbjbjbjbjbjbjbjbjbjbjbjbjbjbjbjbjbjbj
bjbjbjbjbjbjbjbjbjbjbjbjbjbjbjbjbjbjbjbjbjbjbjbjbjbjbjbjbjbj
bjbjbjbjbjbjbjbjbjbjbjbjbjbjbjbjbjbjbjbjbjbjbjbjbjbjbjbjbjbj
bjbjbjbjbjbjbjbjbjbjbjbjbjbjbjbjbjbjbjbjbjbjbjbjbjbjbjbjbjbj
bjbjbjbjbjbjbjbjbjbjbjbjbjbjbjbjbjbjbjbjbjbjbjbjbjbjbjbjbjbj
bjbjbjbjbjbjbjbjbjbjbjbjbjbjbjbjbjbjbjbjbjbjbjbjbjbjbjbjbjbj
bjbjbjbjbjbjbjbjbjbjbjbjbjbjbjbjbjbjbjbjbjbjbjbjbjbjbjbjbjbj
bjbjbjbjbjbjbjbjbjbjbjbjbjbjbjbjbjbjbjbjbjbjbjbjbjbjbjbjbjbj
bjbjbjbjbjbjbjbjbjbjbjbjbjbjbjbjbjbjbjbjbjbjbjbjbjbjbjbjbjbj
bjbjbjbjbjbjbjbjbjbjbjbjbjbjbjbjbjbjbjbjbjbjbjbjbjbjbjbjbjbj
bjbjbjbjbjbjbjbjbjbjbjbjbjbjbjbjbjbjbjbjbjbjbjbjbjbjbjbjbjbj
bjbjbjbjbjbjbjbjbjbjbjbjbjbjbjbjbjbjbjbjbjbjbjbjbjbjbjbjbjbj
bjbjbjbjbjbjbjbjbjbjbjbjbjbjbjbjbjbjbjbjbjbjbjbjbjbjbjbjbjbj
bjbjbjbjbjbjbjbjbjbjbjbjbjbjbjbjbjbjbjbjbjbjbjbjbjbjbjbjbjbj
bjbjbjbjbjbjbjbjbjbjbjbjbjbjbjbjbjbjbjbjbjbjbjbjbjbjbjbjbjbj
bjbjbjbjbjbjbjbjbjbjbjbjbjbjbjbjbjbjbjbjbjbjbjbjbjbjbjbjbjbj
bjbjbjbjbjbjbjbjbjbjbjbjbjbjbjbjbjbjbjbjbjbjbjbjbjbjbjbjbjbj
bjbjbjbjbjbjbjbjbjbjbjbjbjbjbjbjbjbjbjbjbjbjbjbjbjbjbjbjbjbj
bjbjbjbjbjbjbjbjbjbjbjbjbjbjbjbjbjbjbjbjbjbjbjbjbjbjbjbjbjbj
bjbjbjbjbjbjbjbjbjbjbjbjbjbjbjbjbjbjbjbjbjbjbjbjbjbjbjbjbjbj
"}

(1,1,5) = {"
bjbjbjbjbjbjbjbjbjbjbjbjbjbjbjbjbjbjbjbjbjbjbjbjbjbjbjbjbjbj
bjbjbjbjbjbjbjbjbjbjbjbjbjbjbjbjbjbjbjbjbjbjbjbjbjbjbjbjbjbj
bjbjbjbjbjbjbjbjbjbjbjbjbjbjbjbjbjbjbjbjbjbjbjbjbjbjbjbjbjbj
bjbjbjbjbjbjbjbjbjbjbjbjbjbjbjbjbjbjbjbjbjbjbjbjbjbjbjbjbjbj
bjbjbjbjbjbjbjbjbjbjbjbjbjbjbjbjbjbjbjbjbjbjbjbjbjbjbjbjbjbj
bjbjbjbjbjbjbjbjbjbjbjbjbjbjbjbjbjbjbjbjbjbjbjbjbjbjbjbjbjbj
bjbjbjbjbjbjbjbjbjbjbjbjbjbjbjbjbjbjbjbjbjbjbjbjbjbjbjbjbjbj
bjbjbjbjbjbjbjbjbjbjbjbjbjbjbjbjbjbjbjbjbjbjbjbjbjbjbjbjbjbj
bjbjbjbjbjbjbjbjbjbjbjbjbjbjbjbjbjbjbjbjbjbjbjbjbjbjbjbjbjbj
bjbjbjbjbjbjbjbjbjbjbjbjbjbjbjbjbjbjbjbjbjbjbjbjbjbjbjbjbjbj
bjbjbjbjbjbjbjbjbjbjbjbjbjbjbjbjbjbjbjbjbjbjbjbjbjbjbjbjbjbj
bjbjbjbjbjbjbjbjbjbjbjbjbjbjbjbjbjbjbjbjbjbjbjbjbjbjbjbjbjbj
bjbjbjbjbjbjbjbjbjbjbjbjbjbjbjbjbjbjbjbjbjbjbjbjbjbjbjbjbjbj
bjbjbjbjbjbjbjbjbjbjbjbjbjbjbjbjbjbjbjbjbjbjbjbjbjbjbjbjbjbj
bjbjbjbjbjbjbjbjbjbjbjbjbjbjbjbjbjbjbjbjbjbjbjbjbjbjbjbjbjbj
bjbjbjbjbjbjbjbjbjbjbjbjbjbjbjbjbjbjbjbjbjbjbjbjbjbjbjbjbjbj
bjbjbjbjbjbjbjbjbjbjbjbjbjbjbjbjbjbjbjbjbjbjbjbjbjbjbjbjbjbj
bjbjbjbjbjbjbjbjbjbjbjbjbjbjbjbjbjbjbjbjbjbjbjbjbjbjbjbjbjbj
bjbjbjbjbjbjbjbjbjbjbjbjbjbjbjbjbjbjbjbjbjbjbjbjbjbjbjbjbjbj
bjbjbjbjbjbjbjbjbjbjbjbjbjbjbjbjbjbjbjbjbjbjbjbjbjbjbjbjbjbj
bjbjbjbjbjbjbjbjbjbjbjbjbjbjbjbjbjbjbjbjbjbjbjbjbjbjbjbjbjbj
bjbjbjbjbjbjbjbjbjbjbjbjbjbjbjbjbjbjbjbjbjbjbjbjbjbjbjbjbjbj
bjbjbjbjbjbjbjbjbjbjbjbjbjbjbjbjbjbjbjbjbjbjbjbjbjbjbjbjbjbj
bjbjbjbjbjbjbjbjbjbjbjbjbjbjbjbjbjbjbjbjbjbjbjbjbjbjbjbjbjbj
bjbjbjbjbjbjbjbjbjbjbjbjbjbjbjbjbjbjbjbjbjbjbjbjbjbjbjbjbjbj
bjbjbjbjbjbjbjbjbjbjbjbjbjbjbjbjbjbjbjbjbjbjbjbjbjbjbjbjbjbj
bjbjbjbjbjbjbjbjbjbjbjbjbjbjbjbjbjbjbjbjbjbjbjbjbjbjbjbjbjbj
bjbjbjbjbjbjbjbjbjbjbjbjbjbjbjbjbjbjbjbjbjbjbjbjbjbjbjbjbjbj
bjbjbjbjbjbjbjbjbjbjbjbjbjbjbjbjbjbjbjbjbjbjbjbjbjbjbjbjbjbj
bjbjbjbjbjbjbjbjbjbjbjbjbjbjbjbjbjbjbjbjbjbjbjbjbjbjbjbjbjbj
"}
