"aa" = (/turf/wall/generic,/area/underground)
"ab" = (/turf/wall/rock,/area/underground)
"ac" = (/turf/floor/generic/wooden,/area/underground)
"ad" = (/obj/electricity/lightbulb/east,/turf/floor/generic/wooden,/area/underground)
"ae" = (/liquid/lava,/turf/floor/rock,/area/underground)
"af" = (/obj/electricity/lightbulb/west,/turf/floor/generic/wooden,/area/underground)
"ag" = (/obj/electricity/lightbulb,/turf/floor/generic/wooden,/area/underground)
"ah" = (/obj/electricity/machine/door,/turf/floor/generic/red,/area/underground)
"ai" = (/obj/electricity/lightbulb/north,/turf/floor/generic/red,/area/underground)
"aj" = (/turf/floor/generic/red,/area/underground)
"ak" = (/turf/wall/window,/area/underground)
"al" = (/obj/electricity/lightswitch/east,/turf/floor/generic/wooden,/area/underground)
"am" = (/obj/electricity/lightbulb,/turf/floor/generic/red,/area/underground)
"an" = (/obj/electricity/elevator/button/west,/turf/floor/generic/red,/area/underground)
"ao" = (/obj/electricity/machine/door,/turf/floor/generic/black,/area/underground)
"ap" = (/turf/wall/generic,/area/elevator)
"aq" = (/obj/electricity/machine/door/elevator_door,/turf/floor/generic/black,/area/elevator)
"ar" = (/turf/floor/generic/black,/area/underground)
"as" = (/turf/floor/generic/chess,/area/underground)
"at" = (/obj/electricity/elevator/button/east,/turf/floor/generic/chess,/area/underground)
"au" = (/turf/floor/generic/black,/area/elevator)
"av" = (/obj/electricity/elevator/controls/north,/turf/floor/generic/black,/area/elevator)
"aw" = (/obj/electricity/elevator/button/west,/turf/floor/generic/chess,/area/underground)
"ax" = (/obj/electricity/lightbulb,/turf/floor/generic/black,/area/underground)
"ay" = (/obj/electricity/lightbulb/west,/turf/floor/generic/chess,/area/underground)
"az" = (/obj/electricity/lightbulb/east,/turf/floor/generic/chess,/area/underground)
"aA" = (/obj/electricity/lightbulb/west,/turf/floor/generic/black,/area/elevator)
"aB" = (/obj/electricity/lightbulb/east,/turf/floor/generic/black,/area/elevator)
"aC" = (/obj/electricity/machine/door,/turf/floor/generic/chess,/area/underground)
"aD" = (/liquid/lava,/turf/floor/generic/wooden,/area/underground)
"aE" = (/turf/floor/generic/white,/area/underground)
"aF" = (/obj/item/ball,/turf/floor/generic/wooden,/area/underground)
"aG" = (/obj/electricity/lightbulb/west,/turf/floor/generic/red,/area/underground)
"aH" = (/obj/electricity/lightbulb/east,/turf/floor/generic/red,/area/underground)
"aI" = (/obj/electricity/lightbulb/west,/turf/floor/generic/white,/area/underground)
"aJ" = (/obj/item/backpack,/turf/floor/generic/wooden,/area/underground)
"aK" = (/liquid/water,/turf/floor/generic/wooden,/area/underground)
"aL" = (/turf/floor/rock,/area/underground)
"aM" = (/obj/electricity/elevator/button/west,/turf/floor/rock,/area/underground)
"aN" = (/obj/electricity/lightbulb/east,/turf/floor/rock,/area/underground)
"aO" = (/turf/wall/generic,/area/elevator{name = "Elevator0"})
"aP" = (/obj/electricity/machine/door/elevator_door,/turf/floor/generic/black,/area/elevator{name = "Elevator0"})
"aQ" = (/turf/floor/generic/black,/area/elevator{name = "Elevator0"})
"aR" = (/obj/electricity/lightbulb/north,/turf/floor/generic/chess,/area/underground)
"aS" = (/obj/electricity/elevator/button/east,/turf/floor/generic/red,/area/underground)
"aT" = (/obj/electricity/lightbulb/south,/turf/floor/generic/chess,/area/underground)
"aU" = (/obj/electricity/elevator/button/north,/turf/floor/rock,/area/underground)
"aV" = (/obj/electricity/lightbulb/north,/turf/floor/rock,/area/underground)
"aW" = (/obj/electricity/lightbulb,/turf/floor/rock,/area/underground)
"aX" = (/obj/electricity/lightbulb/south,/turf/floor/generic/red,/area/underground)
"aY" = (/obj/electricity/lightbulb/south,/turf/floor/rock,/area/underground)
"aZ" = (/obj/electricity/elevator/button/south,/turf/floor/rock,/area/underground)
"ba" = (/turf/wall/generic,/area/elevator{name = "Elevator1"})
"bb" = (/obj/electricity/machine/door/elevator_door,/turf/floor/generic/black,/area/elevator{name = "Elevator1"})
"bc" = (/turf/floor/generic/black,/area/elevator{name = "Elevator1"})
"bd" = (/obj/electricity/lightbulb/west,/turf/floor/rock,/area/underground)
"be" = (/obj/electricity/elevator/button/east,/turf/floor/rock,/area/underground)
"bf" = (/turf,/area/underground)

(1,1,1) = {"
aaaaaaaaaaaaaaaaaaaaaaaaaaaaaaababababababababababababababab
aaacacacacacacacacacacacacadaaabaeaeaeaeaeaeaeaeaeaeaeaeaeab
aaafacacacacacacacacacacacadaaababababaeaeaeaeaeaeaeaeaeaeab
aaacacacacacagacacacacadaaaaaaaaaaaaabaeaeaeaeaeaeaeaeaeaeab
aaacacacacacacacacacacacahaiajajaiahakaeaeaeaeaeaeaeaeaeaeab
aaacacacacacacacacacacacahajajajajahakaeaeaeaeaeaeaeaeaeaeab
aaacacacacacacacacacacacahajajajajahakaeaeaeaeaeaeaeaeaeaeab
aaacacacacacagacacacacalaaajajajajaaabaeaeaeaeaeaeaeaeaeaeab
aaafacacacacacacacacacadaaamajajamaaabaeaeaeaeaeaeaeaeaeaeab
aaacacacacacacacacacacacaaanajajajaaababababababababababakab
aaaoaaaaaaaaaaaaaaaaapapapaqaqaqaqapapapaaaaaaaaaaaaaaaaaoaa
aaaraaasasasasasasatapauavauauauauauauapawasasasasasasaaaraa
aaaxaaayasasasasasazapaAauauauauauauaBapayasasasasasasaaaxaa
aaaraCasasasasasasasaqauauauauauauauauaqasasasasasasasaCaraa
aaaraaayasasasasasasaqauauauauauauauauaqasasasasasasasaaaraa
aaaxakasasasasasasazapaAauauauauauauaBapayasasasasasasakaxaa
aaarakasasasasasasasapauauauauauauauauapasasasasasasasakaraa
aaaoaaaaaaaaaaaaaaaaapapapaqaqaqaqapapapaaaaaaaaaaaaaaaaaoaa
aaacacacacacacacacacacaDaaanajajajaaaEaEaEaEaEaEaEaEaEaEaEaa
aaacacacacacacacacacacacaaajajajajaaaEaEaEaEaEaEaEaEaEaEaEaa
aaacacacacacacacacacacacakajajajajakaEaEaEaEaEaEaEaEaEaEaEaa
aaacacacagacaFacagacacadaaaGajajaHaaaIaEaEaEaEaEaEaEaEaEaEaa
aaacacacacaJacacacacacacakajajajajakaEaEaEaEaEaEaEaEaEaEaEaa
aaacacacacacacacacacacadaaaGajajaHaaaIaEaEaEaEaEaEaEaEaEaEaa
aaacacacacacacacacacacacakajajajajakaEaEaEaEaEaEaEaEaEaEaEaa
aaacacacagacacacagacacacaaajajajajaaaEaEaEaEaEaEaEaEaEaEaEaa
aaacacacacacacacacacacacahajajajajahaEaEaEaEaEaEaEaEaEaEaEaa
aaacacacacacacacacacacacahajajajajahaEaEaEaEaEaEaEaEaEaEaEaa
aaaKacacacacacacacacacacahajajajajahaEaEaEaEaEaEaEaEaEaEaEaa
aaaaaaaaaaaaaaaaaaaaaaaaaaaaaaaaaaaaaaaaaaaaaaaaaaaaaaaaaaaa
"}

(1,1,2) = {"
abababababababababababababababababababababababababababababab
ababababababababababababababababaLaLaLaLaLababababababababab
abababababababababababababababaLaLaLabaLaLaLabababababababab
abababababababababababababababaLaLaLababaLaLaLababababababab
ababababababababababababababababaLaLaLababaLaLaLaLaLaLaLabab
abababababababababababababababababaLaLaLabababababababaLabab
abababababababababababababababababababababababababababaLabab
ababaLaLaLaLaLaLaLaLaLaLaLaLaLaLaLaLaLaLaLaLaLaLaLaLaLaLabab
ababaLaLaLaLaLaLaLaLaLaLaLaLaLaLaLaLaLaLaLaLaLaLaLaLaLaLabab
ababaLaLabababababababababaMaLaLaNabababababababababaLaLabab
aaaaahahaaaaaaaaaaaaaOaOaOaPaPaPaPaOaOaOaaaaaaaaaaaaaCaCaaaa
aaajajajajajajajajajaOaQaQaQaQaQaQaQaQaOasasasaRasaRasasasaa
aaajajajajajajajajaSaOaQaQaQaQaQaQaQaQaOawasasasasasasasasaa
aaajajajajajajajajajaPaQaQaQaQaQaQaQaQaPasasasasasasasasasaa
aaajajajamajamajajajaPaQaQaQaQaQaQaQaQaPasasasasasasasasasaa
aaajajajajajajajajajaOaQaQaQaQaQaQaQaQaOasasasasasasasasasaa
aaajajajajajajajajajaOaQaQaQaQaQaQaQaQaOasasasaTasaTasasasaa
aaajajajajajajajajajaOaOaOaPaPaPaPaOaOaOaaaaaaaaaaaaaCaCaaaa
aaajajajajajajajajajaaabaUaLabababababababababababababaLaVab
aaajajajajajajajajajaaababaWaLaLaLaLaLaLaLaLaLaLaLaLababaLab
aaajajajajajajajajajaaababababababababaLababaLababaLababaLab
aaajajajajajajajajajaaabaLaLaLaLaLaLaLaLababaLababaLababaLab
aaajajajamajamajajajaaababababababaLabaLababaLababaLaLaLaLab
aaajajajajajajajajajaaababababababaLababababaLababaLabaLabab
aaajajajajajajajajajaaabaLaLaLaLaLaLabaLaLababababababaLabab
aaajajajajajajajajajaaababababaLabaLababaLababababababababab
aaajajajajajajajajajahaLabababaLabaLaLaLaLaLaLaLaLaLaLaLabab
aaajajajajajajajajajahaLaLaLaLaLabaLababaLababababababaLabab
aaajajajaXajaXajajajaaababababababaLababaLaLababaLaLaLaLabab
aaaaaaaaaaaaaaaaaaaaaaababababababababababababababababababab
"}

(1,1,3) = {"
abababababababababababababababababababababababababababababab
abaLaLaLaLaLaLababababababababababababababababababababababab
abaLaLaLaLaLaLaLaLaLaLaLababababababababaLaLaLaLaLababababab
ababababaLaLaLaLaLaLaLaLaLaLaLaLaLaLaLaLaLaLaLaLaLababababab
abababababababaLaLaLaLaLaLabababababababaLaLaLaLaLababaLaLab
abababababababababaLaLaLaLaLaLababababababababaLaLaLabaLaLab
abababababababababaLaLaLaLaLaLababababababababaLaLaLabaLaLab
abababababababababababaLaLaLaLababababababababaLaLaLabaLaLab
ababababababababababababababaLababababababababaLaLaLababaLab
abababababababababababaYaZaLaLaLaLaLaYababababaLaLabababaLab
ababababababababababbabababbbbbbbbbababaabababaLaLabababaLab
abababababababababaNbabcbcbcbcbcbcbcbcbabdababaLaLaLaLaLaLab
abababababababababaLbabcbcbcbcbcbcbcbcbaaMababaLaLaLaLaLaLab
abaLaLaLaLaLaLaLaLaLbbbcbcbcbcbcbcbcbcbbaLabababababaLababab
abaLabababababababaLbbbcbcbcbcbcbcbcbcbbaLabababababaLaLaLab
abaLabababababababbebabcbcbcbcbcbcbcbcbaaLabababababaLaLaLab
abaLabababababababaNbabcbcbcbcbcbcbcbcbabdababababababaLaLab
abaLababababababababbabababbbbbbbbbababaaLaLaLaLabababaLaLab
abaLabababababababababaVaUaLaLaLaLaLaVababababaLaLababababab
abaLabababababaLaLaLabaLabaLaLaLababababababababaLaLaLababab
abaLabababababaLabaLaLaLababaLaLaLabababababababababaLaLabab
abaLabababababaLababababababaLaLaLabababababababababaLaLabab
abaLabababababaLabababababababaLaLaLababababababababaLaLabab
abaLaLaLaLaLaLaLabababababababaLaLaLaLaLaLaLaLaLaLaLaLaLabab
abaLabababababaLabababababababaLaLaLaLaLaLaLaLaLaLaLaLaLabab
abaLabababababaLabababababababababababababababababababababab
abaLabababababaLabababababababababababababababababaLaLaLaLab
abaLabaLaLaLabaLaLaLaLaLaLaLaLaLaLaLaLaLaLaLaLaLaLaLaLaLaLab
abaLaLaLabaLaLaLabababababababababababababababababaLaLaLaLab
abababababababababababababababababababababababababababababab
"}

(1,1,4) = {"
bfbfbfbfbfbfbfbfbfbfbfbfbfbfbfbfbfbfbfbfbfbfbfbfbfbfbfbfbfbf
bfbfbfbfbfbfbfbfbfbfbfbfbfbfbfbfbfbfbfbfbfbfbfbfbfbfbfbfbfbf
bfbfbfbfbfbfbfbfbfbfbfbfbfbfbfbfbfbfbfbfbfbfbfbfbfbfbfbfbfbf
bfbfbfbfbfbfbfbfbfbfbfbfbfbfbfbfbfbfbfbfbfbfbfbfbfbfbfbfbfbf
bfbfbfbfbfbfbfbfbfbfbfbfbfbfbfbfbfbfbfbfbfbfbfbfbfbfbfbfbfbf
bfbfbfbfbfbfbfbfbfbfbfbfbfbfbfbfbfbfbfbfbfbfbfbfbfbfbfbfbfbf
bfbfbfbfbfbfbfbfbfbfbfbfbfbfbfbfbfbfbfbfbfbfbfbfbfbfbfbfbfbf
bfbfbfbfbfbfbfbfbfbfbfbfbfbfbfbfbfbfbfbfbfbfbfbfbfbfbfbfbfbf
bfbfbfbfbfbfbfbfbfbfbfbfbfbfbfbfbfbfbfbfbfbfbfbfbfbfbfbfbfbf
bfbfbfbfbfbfbfbfbfbfbfbfbfbfbfbfbfbfbfbfbfbfbfbfbfbfbfbfbfbf
bfbfbfbfbfbfbfbfbfbfbfbfbfbfbfbfbfbfbfbfbfbfbfbfbfbfbfbfbfbf
bfbfbfbfbfbfbfbfbfbfbfbfbfbfbfbfbfbfbfbfbfbfbfbfbfbfbfbfbfbf
bfbfbfbfbfbfbfbfbfbfbfbfbfbfbfbfbfbfbfbfbfbfbfbfbfbfbfbfbfbf
bfbfbfbfbfbfbfbfbfbfbfbfbfbfbfbfbfbfbfbfbfbfbfbfbfbfbfbfbfbf
bfbfbfbfbfbfbfbfbfbfbfbfbfbfbfbfbfbfbfbfbfbfbfbfbfbfbfbfbfbf
bfbfbfbfbfbfbfbfbfbfbfbfbfbfbfbfbfbfbfbfbfbfbfbfbfbfbfbfbfbf
bfbfbfbfbfbfbfbfbfbfbfbfbfbfbfbfbfbfbfbfbfbfbfbfbfbfbfbfbfbf
bfbfbfbfbfbfbfbfbfbfbfbfbfbfbfbfbfbfbfbfbfbfbfbfbfbfbfbfbfbf
bfbfbfbfbfbfbfbfbfbfbfbfbfbfbfbfbfbfbfbfbfbfbfbfbfbfbfbfbfbf
bfbfbfbfbfbfbfbfbfbfbfbfbfbfbfbfbfbfbfbfbfbfbfbfbfbfbfbfbfbf
bfbfbfbfbfbfbfbfbfbfbfbfbfbfbfbfbfbfbfbfbfbfbfbfbfbfbfbfbfbf
bfbfbfbfbfbfbfbfbfbfbfbfbfbfbfbfbfbfbfbfbfbfbfbfbfbfbfbfbfbf
bfbfbfbfbfbfbfbfbfbfbfbfbfbfbfbfbfbfbfbfbfbfbfbfbfbfbfbfbfbf
bfbfbfbfbfbfbfbfbfbfbfbfbfbfbfbfbfbfbfbfbfbfbfbfbfbfbfbfbfbf
bfbfbfbfbfbfbfbfbfbfbfbfbfbfbfbfbfbfbfbfbfbfbfbfbfbfbfbfbfbf
bfbfbfbfbfbfbfbfbfbfbfbfbfbfbfbfbfbfbfbfbfbfbfbfbfbfbfbfbfbf
bfbfbfbfbfbfbfbfbfbfbfbfbfbfbfbfbfbfbfbfbfbfbfbfbfbfbfbfbfbf
bfbfbfbfbfbfbfbfbfbfbfbfbfbfbfbfbfbfbfbfbfbfbfbfbfbfbfbfbfbf
bfbfbfbfbfbfbfbfbfbfbfbfbfbfbfbfbfbfbfbfbfbfbfbfbfbfbfbfbfbf
bfbfbfbfbfbfbfbfbfbfbfbfbfbfbfbfbfbfbfbfbfbfbfbfbfbfbfbfbfbf
"}

(1,1,5) = {"
bfbfbfbfbfbfbfbfbfbfbfbfbfbfbfbfbfbfbfbfbfbfbfbfbfbfbfbfbfbf
bfbfbfbfbfbfbfbfbfbfbfbfbfbfbfbfbfbfbfbfbfbfbfbfbfbfbfbfbfbf
bfbfbfbfbfbfbfbfbfbfbfbfbfbfbfbfbfbfbfbfbfbfbfbfbfbfbfbfbfbf
bfbfbfbfbfbfbfbfbfbfbfbfbfbfbfbfbfbfbfbfbfbfbfbfbfbfbfbfbfbf
bfbfbfbfbfbfbfbfbfbfbfbfbfbfbfbfbfbfbfbfbfbfbfbfbfbfbfbfbfbf
bfbfbfbfbfbfbfbfbfbfbfbfbfbfbfbfbfbfbfbfbfbfbfbfbfbfbfbfbfbf
bfbfbfbfbfbfbfbfbfbfbfbfbfbfbfbfbfbfbfbfbfbfbfbfbfbfbfbfbfbf
bfbfbfbfbfbfbfbfbfbfbfbfbfbfbfbfbfbfbfbfbfbfbfbfbfbfbfbfbfbf
bfbfbfbfbfbfbfbfbfbfbfbfbfbfbfbfbfbfbfbfbfbfbfbfbfbfbfbfbfbf
bfbfbfbfbfbfbfbfbfbfbfbfbfbfbfbfbfbfbfbfbfbfbfbfbfbfbfbfbfbf
bfbfbfbfbfbfbfbfbfbfbfbfbfbfbfbfbfbfbfbfbfbfbfbfbfbfbfbfbfbf
bfbfbfbfbfbfbfbfbfbfbfbfbfbfbfbfbfbfbfbfbfbfbfbfbfbfbfbfbfbf
bfbfbfbfbfbfbfbfbfbfbfbfbfbfbfbfbfbfbfbfbfbfbfbfbfbfbfbfbfbf
bfbfbfbfbfbfbfbfbfbfbfbfbfbfbfbfbfbfbfbfbfbfbfbfbfbfbfbfbfbf
bfbfbfbfbfbfbfbfbfbfbfbfbfbfbfbfbfbfbfbfbfbfbfbfbfbfbfbfbfbf
bfbfbfbfbfbfbfbfbfbfbfbfbfbfbfbfbfbfbfbfbfbfbfbfbfbfbfbfbfbf
bfbfbfbfbfbfbfbfbfbfbfbfbfbfbfbfbfbfbfbfbfbfbfbfbfbfbfbfbfbf
bfbfbfbfbfbfbfbfbfbfbfbfbfbfbfbfbfbfbfbfbfbfbfbfbfbfbfbfbfbf
bfbfbfbfbfbfbfbfbfbfbfbfbfbfbfbfbfbfbfbfbfbfbfbfbfbfbfbfbfbf
bfbfbfbfbfbfbfbfbfbfbfbfbfbfbfbfbfbfbfbfbfbfbfbfbfbfbfbfbfbf
bfbfbfbfbfbfbfbfbfbfbfbfbfbfbfbfbfbfbfbfbfbfbfbfbfbfbfbfbfbf
bfbfbfbfbfbfbfbfbfbfbfbfbfbfbfbfbfbfbfbfbfbfbfbfbfbfbfbfbfbf
bfbfbfbfbfbfbfbfbfbfbfbfbfbfbfbfbfbfbfbfbfbfbfbfbfbfbfbfbfbf
bfbfbfbfbfbfbfbfbfbfbfbfbfbfbfbfbfbfbfbfbfbfbfbfbfbfbfbfbfbf
bfbfbfbfbfbfbfbfbfbfbfbfbfbfbfbfbfbfbfbfbfbfbfbfbfbfbfbfbfbf
bfbfbfbfbfbfbfbfbfbfbfbfbfbfbfbfbfbfbfbfbfbfbfbfbfbfbfbfbfbf
bfbfbfbfbfbfbfbfbfbfbfbfbfbfbfbfbfbfbfbfbfbfbfbfbfbfbfbfbfbf
bfbfbfbfbfbfbfbfbfbfbfbfbfbfbfbfbfbfbfbfbfbfbfbfbfbfbfbfbfbf
bfbfbfbfbfbfbfbfbfbfbfbfbfbfbfbfbfbfbfbfbfbfbfbfbfbfbfbfbfbf
bfbfbfbfbfbfbfbfbfbfbfbfbfbfbfbfbfbfbfbfbfbfbfbfbfbfbfbfbfbf
"}
