"aa" = (/turf/wall/generic,/area/underground)
"ab" = (/turf/floor/generic/wooden,/area/underground)
"ac" = (/obj/electricity/lightbulb/east,/turf/floor/generic/wooden,/area/underground)
"ad" = (/turf/floor/generic/white,/area/underground)
"ae" = (/obj/electricity/lightbulb/west,/turf/floor/generic/wooden,/area/underground)
"af" = (/obj/electricity/lightbulb,/turf/floor/generic/wooden,/area/underground)
"ag" = (/obj/electricity/machine/door,/turf/floor/generic/red,/area/underground)
"ah" = (/obj/electricity/lightbulb/north,/turf/floor/generic/red,/area/underground)
"ai" = (/turf/floor/generic/red,/area/underground)
"aj" = (/obj/electricity/lightswitch/east,/turf/floor/generic/wooden,/area/underground)
"ak" = (/obj/electricity/lightbulb,/turf/floor/generic/red,/area/underground)
"al" = (/obj/electricity/elevator/button/west,/turf/floor/generic/red,/area/underground)
"am" = (/obj/electricity/machine/door,/turf/floor/generic/black,/area/underground)
"an" = (/turf/wall/generic,/area/elevator)
"ao" = (/obj/electricity/machine/door/elevator_door,/turf/floor/generic/black,/area/elevator)
"ap" = (/turf/floor/generic/black,/area/underground)
"aq" = (/turf/floor/generic/chess,/area/underground)
"ar" = (/obj/electricity/elevator/button/east,/turf/floor/generic/chess,/area/underground)
"as" = (/turf/floor/generic/black,/area/elevator)
"at" = (/obj/electricity/elevator/controls/north,/turf/floor/generic/black,/area/elevator)
"au" = (/obj/electricity/elevator/button/west,/turf/floor/generic/chess,/area/underground)
"av" = (/obj/electricity/lightbulb,/turf/floor/generic/black,/area/underground)
"aw" = (/obj/electricity/lightbulb/west,/turf/floor/generic/chess,/area/underground)
"ax" = (/obj/electricity/lightbulb/east,/turf/floor/generic/chess,/area/underground)
"ay" = (/obj/electricity/lightbulb/west,/turf/floor/generic/black,/area/elevator)
"az" = (/obj/electricity/lightbulb/east,/turf/floor/generic/black,/area/elevator)
"aA" = (/obj/electricity/machine/door,/turf/floor/generic/chess,/area/underground)
"aB" = (/obj/electricity/lightbulb/north,/turf/floor/generic/wooden,/area/underground)
"aC" = (/obj/electricity/elevator/button/south,/turf/floor/generic/wooden,/area/underground)
"aD" = (/turf/wall/generic,/area/elevator{name = "Elevator0"})
"aE" = (/obj/electricity/machine/door/elevator_door,/turf/floor/generic/black,/area/elevator{name = "Elevator0"})
"aF" = (/turf/floor/generic/black,/area/elevator{name = "Elevator0"})
"aG" = (/obj/electricity/lightbulb/north,/turf/floor/generic/chess,/area/underground)
"aH" = (/obj/electricity/elevator/button/east,/turf/floor/generic/red,/area/underground)
"aI" = (/obj/electricity/lightbulb,/turf/floor/generic/chess,/area/underground)
"aJ" = (/obj/electricity/lightbulb/south,/turf/floor/generic/chess,/area/underground)
"aK" = (/obj/electricity/elevator/button/north,/turf/floor/generic/white,/area/underground)
"aL" = (/obj/electricity/lightbulb,/turf/floor/generic/white,/area/underground)
"aM" = (/obj/electricity/lightbulb/north,/turf/floor/generic/white,/area/underground)
"aN" = (/obj/electricity/lightbulb/north,/turf/floor/generic,/area/underground)
"aO" = (/turf/floor/generic,/area/underground)
"aP" = (/obj/electricity/lightbulb/south,/turf/floor/generic,/area/underground)
"aQ" = (/obj/electricity/lightbulb/east,/turf/floor/generic,/area/underground)
"aR" = (/obj/electricity/machine/door,/turf/floor/generic/wooden,/area/underground)
"aS" = (/obj/electricity/lightbulb/west,/turf/floor/generic,/area/underground)
"aT" = (/obj/electricity/lightbulb/south,/turf/floor/generic/white,/area/underground)
"aU" = (/obj/electricity/elevator/button/south,/turf/floor/generic/white,/area/underground)
"aV" = (/turf/wall/generic,/area/elevator{name = "Elevator1"})
"aW" = (/obj/electricity/machine/door/elevator_door,/turf/floor/generic/black,/area/elevator{name = "Elevator1"})
"aX" = (/turf/floor/generic/black,/area/elevator{name = "Elevator1"})
"aY" = (/obj/electricity/lightbulb,/turf/floor/generic,/area/underground)
"aZ" = (/obj/electricity/elevator/button/south,/turf/floor/generic,/area/underground)
"ba" = (/obj/electricity/elevator/button/east,/turf/floor/generic,/area/underground)
"bb" = (/obj/electricity/elevator/button/north,/turf/floor/generic/chess,/area/underground)
"bc" = (/obj/electricity/machine/door,/turf,/area/underground)
"bd" = (/turf,/area/underground)

(1,1,1) = {"
aaaaaaaaaaaaaaaaaaaaaaaaaaaaaaaaaaaaaaaaaaaaaaaaaaaaaaaaaaaa
aaababababababababababababacaaaaadadadadadadadadadadadadadaa
aaaeabababababababababababacaaaaadadadadadadadadadadadadadaa
aaabababababafababababacaaaaaaaaaaaaadadadadadadadadadadadaa
aaabababababababababababagahaiaiahagadadadadadadadadadadadaa
aaabababababababababababagaiaiaiaiagadadadadadadadadadadadaa
aaabababababababababababagaiaiaiaiagadadadadadadadadadadadaa
aaabababababafababababajaaaiaiaiaiaaadadadadadadadadadadadaa
aaaeabababababababababacaaakaiaiakaaadadadadadadadadadadadaa
aaabababababababababababaaalaiaiaiaaadadadadadadadadadadadaa
aaamaaaaaaaaaaaaaaaaanananaoaoaoaoanananaaaaaaaaaaaaaaaaamaa
aaapaaaqaqaqaqaqaqaranasatasasasasasasanauaqaqaqaqaqaqaaapaa
aaavaaawaqaqaqaqaqaxanayasasasasasasazanawaqaqaqaqaqaqaaavaa
aaapaAaqaqaqaqaqaqaqaoasasasasasasasasaoaqaqaqaqaqaqaqaAapaa
aaapaaawaqaqaqaqaqaqaoasasasasasasasasaoaqaqaqaqaqaqaqaaapaa
aaavaaaqaqaqaqaqaqaxanayasasasasasasazanawaqaqaqaqaqaqaaavaa
aaapaaaqaqaqaqaqaqaqanasasasasasasasasanaqaqaqaqaqaqaqaaapaa
aaamaaaaaaaaaaaaaaaaanananaoaoaoaoanananaaaaaaaaaaaaaaaaamaa
aaabababababababababababaaalaiaiaiaaadadadadadadadadadadadaa
aaabababababababababababaaaiaiaiaiaaadadadadadadadadadadadaa
aaabababababababababababaaaiaiaiaiaaadadadadadadadadadadadaa
aaabababababababababababaaaiaiaiaiaaadadadadadadadadadadadaa
aaabababababababababababaaaiaiaiaiaaadadadadadadadadadadadaa
aaabababababababababababaaaiaiaiaiaaadadadadadadadadadadadaa
aaabababababababababababaaaiaiaiaiaaadadadadadadadadadadadaa
aaabababababababababababaaaiaiaiaiaaadadadadadadadadadadadaa
aaabababababababababababagaiaiaiaiagadadadadadadadadadadadaa
aaabababababababababababagaiaiaiaiagadadadadadadadadadadadaa
aaabababababababababababagaiaiaiaiagadadadadadadadadadadadaa
aaaaaaaaaaaaaaaaaaaaaaaaaaaaaaaaaaaaaaaaaaaaaaaaaaaaaaaaaaaa
"}

(1,1,2) = {"
aaaaaaaaaaaaaaaaaaaaaaaaaaaaaaaaaaaaaaaaaaaaaaaaaaaaaaaaaaaa
aaabaBababababaBababababaBababababaBababababaBababababaBabaa
aaababababababababababababababababababababababababababababaa
aaababababababababababababababababababababababababababababaa
aaababababababababababababababababababababababababababababaa
aaabafababababafababababafababababafababababafababababafabaa
aaababababababababababababababababababababababababababababaa
aaababababababababababababababababababababababababababababaa
aaababababababababababababababababababababababababababababaa
aaabababababababababababaCababababababababababababababababaa
aaaaagagaaaaaaaaaaaaaDaDaDaEaEaEaEaDaDaDaaaaaaaaaaaaaAaAaaaa
aaaiaiaiaiaiaiaiaiaiaDaFaFaFaFaFaFaFaFaDaqaGaqaqaGaqaqaqaqaa
aaaiakaiaiakaiaiakaHaDaFaFaFaFaFaFaFaFaDauaqaqaqaqaqaqaIaqaa
aaaiaiaiaiaiaiaiaiaiaEaFaFaFaFaFaFaFaFaEaqaqaqaqaqaqaqaqaqaa
aaaiaiaiaiaiaiaiaiaiaEaFaFaFaFaFaFaFaFaEaqaqaqaqaqaqaqaqaqaa
aaaiakaiaiakaiaiakaiaDaFaFaFaFaFaFaFaFaDaqaqaqaqaqaqaqaIaqaa
aaaiaiaiaiaiaiaiaiaiaDaFaFaFaFaFaFaFaFaDaqaJaqaqaJaqaqaqaqaa
aaaiaiaiaiaiaiaiaiaiaDaDaDaEaEaEaEaDaDaDaaaaaaaaaaaaaAaAaaaa
aaaiakaiaiakaiaiakaiaaadaKadadadadadadadadadadadadadadadadaa
aaaiaiaiaiaiaiaiaiaiaaadaLadadadadaLadadadadaLadadadadaLadaa
aaaiaiaiaiaiaiaiaiaiaaadadadadadadadadadadadadadadadadadadaa
aaaiakaiaiakaiaiakaiaaadadadadadadadadadadadadadadadadadadaa
aaaiaiaiaiaiaiaiaiaiaaadadadadadadadadadadadadadadadadadadaa
aaaiaiaiaiaiaiaiaiaiaaadaLadadadadaLadadadadaLadadadadaLadaa
aaaiakaiaiakaiaiakaiaaadadadadadadadadadadadadadadadadadadaa
aaaiaiaiaiaiaiaiaiaiaaadadadadadadadadadadadadadadadadadadaa
aaaiaiaiaiaiaiaiaiaiagadadadadadadadadadadadadadadadadadadaa
aaaiakaiaiakaiaiakaiagadaLadadadadaLadadadadaLadadadadaLadaa
aaaiaiaiaiaiaiaiaiaiaaadadadadadadadadadadadadadadadadadadaa
aaaaaaaaaaaaaaaaaaaaaaaaaaaaaaaaaaaaaaaaaaaaaaaaaaaaaaaaaaaa
"}

(1,1,3) = {"
aaaaaaaaaaaaaaaaaaaaaaaaaaaaaaaaaaaaaaaaaaaaaaaaaaaaaaaaaaaa
aaadaMadadaMadadaMadadaMadadaMadadaMadaaaNaOaNaOaNaOaNaOaNaa
aaadadadadadadadadadadadadadadadadadadaaaOaOaPaOaPaOaPaOaQaa
aaadadadadadadadadadadadadadadadadadadaaaRaRaaaaaaaaaaaOaOaa
aaadadadadadadadadadadadadadadadadadadaaababababababaaaSaQaa
aaadaLadadaLadadaLadadaLadadaLadadaLadaaaeababababacaaaOaOaa
aaadadadadadadadadadadadadadadadadadadaaababababababaaaSaQaa
aaadadadadadadadadadadadadadadadadadadaaababababababaaaOaOaa
aaadadadadadadadadadadadadadadadadadadaaababababababaaaSaQaa
aaadaTadadaTadadaTadadaTaUadadadadaTadaaababababababaaaOaOaa
aaaaaaaaaaaaaaaaaaaaaVaVaVaWaWaWaWaVaVaVaeababababacaaaSaQaa
aaaOaOaOaOaOaOaOaOaOaVaXaXaXaXaXaXaXaXaVababababababaaaOaOaa
aaaSaOaOaOaYaOaOaOaQaVaXaXaXaXaXaXaXaXaVaaaaaaaaaaaaaaaSaQaa
aaaOaOaOaOaOaOaOaOaOaWaXaXaXaXaXaXaXaXaWaOaNaOaNaOaNaOaYaOaa
aaaOaOaOaOaOaOaOaOaOaWaXaXaXaXaXaXaXaXaWaZaPaOaPaOaPaOaOaOaa
aaaSaOaOaOaYaOaOaObaaVaXaXaXaXaXaXaXaXaVaaaaaaaaaaaaaaagagaa
aaaOaOaOaOaOaOaOaOaOaVaXaXaXaXaXaXaXaXaVaiaiaiaiaiaiaiaiaiaa
aaaOaOaOaOaOaOaOaOaOaVaVaVaWaWaWaWaVaVaVaiaiaiaiaiaiaiaiaiaa
aaaSaOaOaOaYaOaOaOaQaaaqbbaqaqaqaqaqaqaaaiaiaiaiaiaiaiaiaiaa
aaaOaOaOaOaOaOaOaOaOaaaqaIaqaqaqaqaIaqagaiaiaiaiaiaiaiaiaiaa
aaaOaOaOaOaOaOaOaOaOaaaqaIaqaqaqaqaIaqagaiaiaiaiaiaiaiaiaiaa
aaaSaOaOaOaYaOaOaOaQaaaqaqaqaqaqaqaqaqaaaiaiaiaiaiaiaiaiaiaa
aaaOaOaOaOaOaOaOaOaOaaaaaaaaaaaaaaaaaaaaaaaaaaaaaaaaaaaaaaaa
aaaOaOaOaOaOaOaOaOaOaaapadapadapadapadapadapadapadapadapadaa
aaaSaOaOaOaYaOaOaOaQaaadapaLapadapaLapadapadavadapadavadapaa
aaaOaOaOaOaOaOaOaOaObcapadapadapadapadapadapadapadapadapadaa
aaaOaOaOaOaOaOaOaOaObcadapadapadapadapadapadapadapadapadapaa
aaaSaOaOaOaYaOaOaOaQaaapadavadapadavadapadapaLapadapaLapadaa
aaaOaOaOaOaOaOaOaOaOaaadapadapadapadapadapadapadapadapadapaa
aaaaaaaaaaaaaaaaaaaaaaaaaaaaaaaaaaaaaaaaaaaaaaaaaaaaaaaaaaaa
"}

(1,1,4) = {"
bdbdbdbdbdbdbdbdbdbdbdbdbdbdbdbdbdbdbdbdbdbdbdbdbdbdbdbdbdbd
bdbdbdbdbdbdbdbdbdbdbdbdbdbdbdbdbdbdbdbdbdbdbdbdbdbdbdbdbdbd
bdbdbdbdbdbdbdbdbdbdbdbdbdbdbdbdbdbdbdbdbdbdbdbdbdbdbdbdbdbd
bdbdbdbdbdbdbdbdbdbdbdbdbdbdbdbdbdbdbdbdbdbdbdbdbdbdbdbdbdbd
bdbdbdbdbdbdbdbdbdbdbdbdbdbdbdbdbdbdbdbdbdbdbdbdbdbdbdbdbdbd
bdbdbdbdbdbdbdbdbdbdbdbdbdbdbdbdbdbdbdbdbdbdbdbdbdbdbdbdbdbd
bdbdbdbdbdbdbdbdbdbdbdbdbdbdbdbdbdbdbdbdbdbdbdbdbdbdbdbdbdbd
bdbdbdbdbdbdbdbdbdbdbdbdbdbdbdbdbdbdbdbdbdbdbdbdbdbdbdbdbdbd
bdbdbdbdbdbdbdbdbdbdbdbdbdbdbdbdbdbdbdbdbdbdbdbdbdbdbdbdbdbd
bdbdbdbdbdbdbdbdbdbdbdbdbdbdbdbdbdbdbdbdbdbdbdbdbdbdbdbdbdbd
bdbdbdbdbdbdbdbdbdbdbdbdbdbdbdbdbdbdbdbdbdbdbdbdbdbdbdbdbdbd
bdbdbdbdbdbdbdbdbdbdbdbdbdbdbdbdbdbdbdbdbdbdbdbdbdbdbdbdbdbd
bdbdbdbdbdbdbdbdbdbdbdbdbdbdbdbdbdbdbdbdbdbdbdbdbdbdbdbdbdbd
bdbdbdbdbdbdbdbdbdbdbdbdbdbdbdbdbdbdbdbdbdbdbdbdbdbdbdbdbdbd
bdbdbdbdbdbdbdbdbdbdbdbdbdbdbdbdbdbdbdbdbdbdbdbdbdbdbdbdbdbd
bdbdbdbdbdbdbdbdbdbdbdbdbdbdbdbdbdbdbdbdbdbdbdbdbdbdbdbdbdbd
bdbdbdbdbdbdbdbdbdbdbdbdbdbdbdbdbdbdbdbdbdbdbdbdbdbdbdbdbdbd
bdbdbdbdbdbdbdbdbdbdbdbdbdbdbdbdbdbdbdbdbdbdbdbdbdbdbdbdbdbd
bdbdbdbdbdbdbdbdbdbdbdbdbdbdbdbdbdbdbdbdbdbdbdbdbdbdbdbdbdbd
bdbdbdbdbdbdbdbdbdbdbdbdbdbdbdbdbdbdbdbdbdbdbdbdbdbdbdbdbdbd
bdbdbdbdbdbdbdbdbdbdbdbdbdbdbdbdbdbdbdbdbdbdbdbdbdbdbdbdbdbd
bdbdbdbdbdbdbdbdbdbdbdbdbdbdbdbdbdbdbdbdbdbdbdbdbdbdbdbdbdbd
bdbdbdbdbdbdbdbdbdbdbdbdbdbdbdbdbdbdbdbdbdbdbdbdbdbdbdbdbdbd
bdbdbdbdbdbdbdbdbdbdbdbdbdbdbdbdbdbdbdbdbdbdbdbdbdbdbdbdbdbd
bdbdbdbdbdbdbdbdbdbdbdbdbdbdbdbdbdbdbdbdbdbdbdbdbdbdbdbdbdbd
bdbdbdbdbdbdbdbdbdbdbdbdbdbdbdbdbdbdbdbdbdbdbdbdbdbdbdbdbdbd
bdbdbdbdbdbdbdbdbdbdbdbdbdbdbdbdbdbdbdbdbdbdbdbdbdbdbdbdbdbd
bdbdbdbdbdbdbdbdbdbdbdbdbdbdbdbdbdbdbdbdbdbdbdbdbdbdbdbdbdbd
bdbdbdbdbdbdbdbdbdbdbdbdbdbdbdbdbdbdbdbdbdbdbdbdbdbdbdbdbdbd
bdbdbdbdbdbdbdbdbdbdbdbdbdbdbdbdbdbdbdbdbdbdbdbdbdbdbdbdbdbd
"}

(1,1,5) = {"
bdbdbdbdbdbdbdbdbdbdbdbdbdbdbdbdbdbdbdbdbdbdbdbdbdbdbdbdbdbd
bdbdbdbdbdbdbdbdbdbdbdbdbdbdbdbdbdbdbdbdbdbdbdbdbdbdbdbdbdbd
bdbdbdbdbdbdbdbdbdbdbdbdbdbdbdbdbdbdbdbdbdbdbdbdbdbdbdbdbdbd
bdbdbdbdbdbdbdbdbdbdbdbdbdbdbdbdbdbdbdbdbdbdbdbdbdbdbdbdbdbd
bdbdbdbdbdbdbdbdbdbdbdbdbdbdbdbdbdbdbdbdbdbdbdbdbdbdbdbdbdbd
bdbdbdbdbdbdbdbdbdbdbdbdbdbdbdbdbdbdbdbdbdbdbdbdbdbdbdbdbdbd
bdbdbdbdbdbdbdbdbdbdbdbdbdbdbdbdbdbdbdbdbdbdbdbdbdbdbdbdbdbd
bdbdbdbdbdbdbdbdbdbdbdbdbdbdbdbdbdbdbdbdbdbdbdbdbdbdbdbdbdbd
bdbdbdbdbdbdbdbdbdbdbdbdbdbdbdbdbdbdbdbdbdbdbdbdbdbdbdbdbdbd
bdbdbdbdbdbdbdbdbdbdbdbdbdbdbdbdbdbdbdbdbdbdbdbdbdbdbdbdbdbd
bdbdbdbdbdbdbdbdbdbdbdbdbdbdbdbdbdbdbdbdbdbdbdbdbdbdbdbdbdbd
bdbdbdbdbdbdbdbdbdbdbdbdbdbdbdbdbdbdbdbdbdbdbdbdbdbdbdbdbdbd
bdbdbdbdbdbdbdbdbdbdbdbdbdbdbdbdbdbdbdbdbdbdbdbdbdbdbdbdbdbd
bdbdbdbdbdbdbdbdbdbdbdbdbdbdbdbdbdbdbdbdbdbdbdbdbdbdbdbdbdbd
bdbdbdbdbdbdbdbdbdbdbdbdbdbdbdbdbdbdbdbdbdbdbdbdbdbdbdbdbdbd
bdbdbdbdbdbdbdbdbdbdbdbdbdbdbdbdbdbdbdbdbdbdbdbdbdbdbdbdbdbd
bdbdbdbdbdbdbdbdbdbdbdbdbdbdbdbdbdbdbdbdbdbdbdbdbdbdbdbdbdbd
bdbdbdbdbdbdbdbdbdbdbdbdbdbdbdbdbdbdbdbdbdbdbdbdbdbdbdbdbdbd
bdbdbdbdbdbdbdbdbdbdbdbdbdbdbdbdbdbdbdbdbdbdbdbdbdbdbdbdbdbd
bdbdbdbdbdbdbdbdbdbdbdbdbdbdbdbdbdbdbdbdbdbdbdbdbdbdbdbdbdbd
bdbdbdbdbdbdbdbdbdbdbdbdbdbdbdbdbdbdbdbdbdbdbdbdbdbdbdbdbdbd
bdbdbdbdbdbdbdbdbdbdbdbdbdbdbdbdbdbdbdbdbdbdbdbdbdbdbdbdbdbd
bdbdbdbdbdbdbdbdbdbdbdbdbdbdbdbdbdbdbdbdbdbdbdbdbdbdbdbdbdbd
bdbdbdbdbdbdbdbdbdbdbdbdbdbdbdbdbdbdbdbdbdbdbdbdbdbdbdbdbdbd
bdbdbdbdbdbdbdbdbdbdbdbdbdbdbdbdbdbdbdbdbdbdbdbdbdbdbdbdbdbd
bdbdbdbdbdbdbdbdbdbdbdbdbdbdbdbdbdbdbdbdbdbdbdbdbdbdbdbdbdbd
bdbdbdbdbdbdbdbdbdbdbdbdbdbdbdbdbdbdbdbdbdbdbdbdbdbdbdbdbdbd
bdbdbdbdbdbdbdbdbdbdbdbdbdbdbdbdbdbdbdbdbdbdbdbdbdbdbdbdbdbd
bdbdbdbdbdbdbdbdbdbdbdbdbdbdbdbdbdbdbdbdbdbdbdbdbdbdbdbdbdbd
bdbdbdbdbdbdbdbdbdbdbdbdbdbdbdbdbdbdbdbdbdbdbdbdbdbdbdbdbdbd
"}
