"aa" = (/turf/wall/generic,/area/underground)
"ab" = (/turf/floor/generic/wooden,/area/underground)
"ac" = (/obj/electricity/lightbulb/east,/turf/floor/generic/wooden,/area/underground)
"ad" = (/turf/floor/generic/white,/area/underground)
"ae" = (/obj/electricity/lightbulb/west,/turf/floor/generic/wooden,/area/underground)
"af" = (/obj/electricity/lightbulb,/turf/floor/generic/wooden,/area/underground)
"ag" = (/obj/electricity/machine/door,/turf/floor/generic/red,/area/underground)
"ah" = (/obj/electricity/lightbulb/north,/turf/floor/generic/red,/area/underground)
"ai" = (/turf/floor/generic/red,/area/underground)
"aj" = (/obj/electricity/lightswitch/east,/turf/floor/generic/wooden,/area/underground)
"ak" = (/obj/electricity/lightbulb,/turf/floor/generic/red,/area/underground)
"al" = (/obj/electricity/elevator/button/west,/turf/floor/generic/red,/area/underground)
"am" = (/obj/electricity/machine/door,/turf/floor/generic/black,/area/underground)
"an" = (/turf/wall/generic,/area/elevator)
"ao" = (/obj/electricity/machine/door/elevator_door,/turf/floor/generic/black,/area/elevator)
"ap" = (/turf/floor/generic/black,/area/underground)
"aq" = (/turf/floor/generic/chess,/area/underground)
"ar" = (/obj/electricity/elevator/button/east,/turf/floor/generic/chess,/area/underground)
"as" = (/turf/floor/generic/black,/area/elevator)
"at" = (/obj/electricity/elevator/controls/north,/turf/floor/generic/black,/area/elevator)
"au" = (/obj/electricity/elevator/button/west,/turf/floor/generic/chess,/area/underground)
"av" = (/obj/electricity/lightbulb,/turf/floor/generic/black,/area/underground)
"aw" = (/obj/electricity/lightbulb/west,/turf/floor/generic/chess,/area/underground)
"ax" = (/obj/electricity/lightbulb/east,/turf/floor/generic/chess,/area/underground)
"ay" = (/obj/electricity/lightbulb/west,/turf/floor/generic/black,/area/elevator)
"az" = (/obj/electricity/lightbulb/east,/turf/floor/generic/black,/area/elevator)
"aA" = (/obj/electricity/machine/door,/turf/floor/generic/chess,/area/underground)
"aB" = (/obj/electricity/lightbulb/north,/turf/floor/generic/wooden,/area/underground)
"aC" = (/obj/electricity/lightbulb/south,/turf/floor/generic/wooden,/area/underground)
"aD" = (/obj/electricity/elevator/button/south,/turf/floor/generic/wooden,/area/underground)
"aE" = (/turf/wall/generic,/area/elevator{name = "Elevator0"})
"aF" = (/obj/electricity/machine/door/elevator_door,/turf/floor/generic/black,/area/elevator{name = "Elevator0"})
"aG" = (/turf/floor/generic/black,/area/elevator{name = "Elevator0"})
"aH" = (/obj/electricity/lightbulb/north,/turf/floor/generic/chess,/area/underground)
"aI" = (/obj/electricity/elevator/button/east,/turf/floor/generic/red,/area/underground)
"aJ" = (/obj/electricity/lightbulb/south,/turf/floor/generic/chess,/area/underground)
"aK" = (/obj/electricity/elevator/button/north,/turf/floor/generic/white,/area/underground)
"aL" = (/obj/electricity/lightbulb,/turf/floor/generic/white,/area/underground)
"aM" = (/obj/electricity/lightbulb/south,/turf/floor/generic/red,/area/underground)
"aN" = (/obj/electricity/lightbulb/north,/turf/floor/generic/white,/area/underground)
"aO" = (/obj/electricity/lightbulb/north,/turf/floor/generic,/area/underground)
"aP" = (/turf/floor/generic,/area/underground)
"aQ" = (/obj/electricity/lightbulb/south,/turf/floor/generic,/area/underground)
"aR" = (/obj/electricity/lightbulb/east,/turf/floor/generic,/area/underground)
"aS" = (/obj/electricity/machine/door,/turf/floor/generic/wooden,/area/underground)
"aT" = (/obj/electricity/lightbulb/west,/turf/floor/generic,/area/underground)
"aU" = (/obj/electricity/lightbulb/south,/turf/floor/generic/white,/area/underground)
"aV" = (/obj/electricity/elevator/button/south,/turf/floor/generic/white,/area/underground)
"aW" = (/turf/wall/generic,/area/elevator{name = "Elevator1"})
"aX" = (/obj/electricity/machine/door/elevator_door,/turf/floor/generic/black,/area/elevator{name = "Elevator1"})
"aY" = (/turf/floor/generic/black,/area/elevator{name = "Elevator1"})
"aZ" = (/obj/electricity/elevator/button/south,/turf/floor/generic,/area/underground)
"ba" = (/obj/electricity/elevator/button/east,/turf/floor/generic,/area/underground)
"bb" = (/obj/electricity/elevator/button/north,/turf/floor/generic/chess,/area/underground)
"bc" = (/obj/electricity/machine/door,/turf,/area/underground)
"bd" = (/obj/electricity/lightbulb/south,/turf/floor/generic/black,/area/underground)
"be" = (/turf,/area/underground)

(1,1,1) = {"
aaaaaaaaaaaaaaaaaaaaaaaaaaaaaaaaaaaaaaaaaaaaaaaaaaaaaaaaaaaa
aaababababababababababababacaaaaadadadadadadadadadadadadadaa
aaaeabababababababababababacaaaaadadadadadadadadadadadadadaa
aaabababababafababababacaaaaaaaaaaaaadadadadadadadadadadadaa
aaabababababababababababagahaiaiahagadadadadadadadadadadadaa
aaabababababababababababagaiaiaiaiagadadadadadadadadadadadaa
aaabababababababababababagaiaiaiaiagadadadadadadadadadadadaa
aaabababababafababababajaaaiaiaiaiaaadadadadadadadadadadadaa
aaaeabababababababababacaaakaiaiakaaadadadadadadadadadadadaa
aaabababababababababababaaalaiaiaiaaadadadadadadadadadadadaa
aaamaaaaaaaaaaaaaaaaanananaoaoaoaoanananaaaaaaaaaaaaaaaaamaa
aaapaaaqaqaqaqaqaqaranasatasasasasasasanauaqaqaqaqaqaqaaapaa
aaavaaawaqaqaqaqaqaxanayasasasasasasazanawaqaqaqaqaqaqaaavaa
aaapaAaqaqaqaqaqaqaqaoasasasasasasasasaoaqaqaqaqaqaqaqaAapaa
aaapaaawaqaqaqaqaqaqaoasasasasasasasasaoaqaqaqaqaqaqaqaaapaa
aaavaaaqaqaqaqaqaqaxanayasasasasasasazanawaqaqaqaqaqaqaaavaa
aaapaaaqaqaqaqaqaqaqanasasasasasasasasanaqaqaqaqaqaqaqaaapaa
aaamaaaaaaaaaaaaaaaaanananaoaoaoaoanananaaaaaaaaaaaaaaaaamaa
aaabababababababababababaaalaiaiaiaaadadadadadadadadadadadaa
aaabababababababababababaaaiaiaiaiaaadadadadadadadadadadadaa
aaabababababababababababaaaiaiaiaiaaadadadadadadadadadadadaa
aaabababafabababafabababaaaiaiaiaiaaadadadadadadadadadadadaa
aaabababababababababababaaaiaiaiaiaaadadadadadadadadadadadaa
aaabababababababababababaaaiaiaiaiaaadadadadadadadadadadadaa
aaabababababababababababaaaiaiaiaiaaadadadadadadadadadadadaa
aaabababafabababafabababaaaiaiaiaiaaadadadadadadadadadadadaa
aaabababababababababababagaiaiaiaiagadadadadadadadadadadadaa
aaabababababababababababagaiaiaiaiagadadadadadadadadadadadaa
aaabababababababababababagaiaiaiaiagadadadadadadadadadadadaa
aaaaaaaaaaaaaaaaaaaaaaaaaaaaaaaaaaaaaaaaaaaaaaaaaaaaaaaaaaaa
"}

(1,1,2) = {"
aaaaaaaaaaaaaaaaaaaaaaaaaaaaaaaaaaaaaaaaaaaaaaaaaaaaaaaaaaaa
aaabababaBababababababaBababababababaBababababababaBabababaa
aaababababababababababababababababababababababababababababaa
aaababababababababababababababababababababababababababababaa
aaababababababababababababababababababababababababababababaa
aaababababababababababababababababababababababababababababaa
aaababababababababababababababababababababababababababababaa
aaababababababababababababababababababababababababababababaa
aaababababababababababababababababababababababababababababaa
aaabababaCababababababaCaDabababababaCababababababaCabababaa
aaaaagagaaaaaaaaaaaaaEaEaEaFaFaFaFaEaEaEaaaaaaaaaaaaaAaAaaaa
aaaiaiaiaiaiaiaiaiaiaEaGaGaGaGaGaGaGaGaEaqaqaqaHaqaHaqaqaqaa
aaaiaiaiaiaiaiaiaiaIaEaGaGaGaGaGaGaGaGaEauaqaqaqaqaqaqaqaqaa
aaaiaiaiaiaiaiaiaiaiaFaGaGaGaGaGaGaGaGaFaqaqaqaqaqaqaqaqaqaa
aaaiaiaiakaiakaiaiaiaFaGaGaGaGaGaGaGaGaFaqaqaqaqaqaqaqaqaqaa
aaaiaiaiaiaiaiaiaiaiaEaGaGaGaGaGaGaGaGaEaqaqaqaqaqaqaqaqaqaa
aaaiaiaiaiaiaiaiaiaiaEaGaGaGaGaGaGaGaGaEaqaqaqaJaqaJaqaqaqaa
aaaiaiaiaiaiaiaiaiaiaEaEaEaFaFaFaFaEaEaEaaaaaaaaaaaaaAaAaaaa
aaaiaiaiaiaiaiaiaiaiaaadaKadadadadadadadadadadadadadadadadaa
aaaiaiaiaiaiaiaiaiaiaaadadadadadadadadadadadadadadadadadadaa
aaaiaiaiaiaiaiaiaiaiaaadadadadadadadadadadadadadadadadadadaa
aaaiaiaiaiaiaiaiaiaiaaadadadaLadadadaLadadaLadadadaLadadadaa
aaaiaiaiakaiakaiaiaiaaadadadadadadadadadadadadadadadadadadaa
aaaiaiaiaiaiaiaiaiaiaaadadadadadadadadadadadadadadadadadadaa
aaaiaiaiaiaiaiaiaiaiaaadadadadadadadadadadadadadadadadadadaa
aaaiaiaiaiaiaiaiaiaiaaadadadaLadadadaLadadaLadadadaLadadadaa
aaaiaiaiaiaiaiaiaiaiagadadadadadadadadadadadadadadadadadadaa
aaaiaiaiaiaiaiaiaiaiagadadadadadadadadadadadadadadadadadadaa
aaaiaiaiaMaiaMaiaiaiaaadadadadadadadadadadadadadadadadadadaa
aaaaaaaaaaaaaaaaaaaaaaaaaaaaaaaaaaaaaaaaaaaaaaaaaaaaaaaaaaaa
"}

(1,1,3) = {"
aaaaaaaaaaaaaaaaaaaaaaaaaaaaaaaaaaaaaaaaaaaaaaaaaaaaaaaaaaaa
aaadaNadadadadadaNadadaNadadadadadaNadaaaOaPaOaPaOaPaOaPaOaa
aaadadadadadadadadadadadadadadadadadadaaaPaPaQaPaQaPaQaPaRaa
aaadadadadadadadadadadadadadadadadadadaaaSaSaaaaaaaaaaaPaPaa
aaadadadadadadadadadadadadadadadadadadaaababababababaaaTaRaa
aaadadadadadadadadadadadadadadadadadadaaaeababababacaaaPaPaa
aaadadadadadadadadadadadadadadadadadadaaababababababaaaTaRaa
aaadadadadadadadadadadadadadadadadadadaaababababababaaaPaPaa
aaadadadadadadadadadadadadadadadadadadaaababababababaaaTaRaa
aaadaUadadadadadaUadadaUaVadadadadaUadaaababababababaaaPaPaa
aaaaaaaaaaaaaaaaaaaaaWaWaWaXaXaXaXaWaWaWaeababababacaaaTaRaa
aaaPaPaPaPaPaPaPaPaPaWaYaYaYaYaYaYaYaYaWababababababaaaPaPaa
aaaTaPaPaPaPaPaPaPaRaWaYaYaYaYaYaYaYaYaWaaaaaaaaaaaaaaaTaRaa
aaaPaPaPaPaPaPaPaPaPaXaYaYaYaYaYaYaYaYaXaPaOaPaOaPaOaPaPaPaa
aaaPaPaPaPaPaPaPaPaPaXaYaYaYaYaYaYaYaYaXaZaQaPaQaPaQaPaPaPaa
aaaPaPaPaPaPaPaPaPbaaWaYaYaYaYaYaYaYaYaWaaaaaaaaaaaaaaagagaa
aaaPaPaPaPaPaPaPaPaPaWaYaYaYaYaYaYaYaYaWaiaiaiaiaiaiaiaiaiaa
aaaPaPaPaPaPaPaPaPaPaWaWaWaXaXaXaXaWaWaWaiaiaiaiaiaiaiaiaiaa
aaaPaPaPaPaPaPaPaPaPaaawbbaqaqaqaqaqaxaaaiaiaiaiaiaiaiaiaiaa
aaaPaPaPaPaPaPaPaPaPaaaqaqaqaqaqaqaqaqagaiaiaiaiaiaiaiaiaiaa
aaaTaPaPaPaPaPaPaPaRaaaqaqaqaqaqaqaqaqagaiaiaiaiaiaiaiaiaiaa
aaaPaPaPaPaPaPaPaPaPaaawaqaqaqaqaqaqaxaaaiaiaiaiaiaiaiaiaiaa
aaaPaPaPaPaPaPaPaPaPaaaaaaaaaaaaaaaaaaaaaaaaaaaaaaaaaaaaaaaa
aaaPaPaPaPaPaPaPaPaPaaapadapaNapadapadapaNapadapadapaNapadaa
aaaPaPaPaPaPaPaPaPaPaaadapadapadapadapadapadapadapadapadapaa
aaaPaPaPaPaPaPaPaPaPbcapadapadapadapadapadapadapadapadapadaa
aaaPaPaPaPaPaPaPaPaPbcadapadapadapadapadapadapadapadapadapaa
aaaTaPaPaPaPaPaPaPaRaaapadapadapadapadapadapadapadapadapadaa
aaaPaPaPaPaPaPaPaPaPaaadapadbdadapadapadbdadapadapadbdadapaa
aaaaaaaaaaaaaaaaaaaaaaaaaaaaaaaaaaaaaaaaaaaaaaaaaaaaaaaaaaaa
"}

(1,1,4) = {"
bebebebebebebebebebebebebebebebebebebebebebebebebebebebebebe
bebebebebebebebebebebebebebebebebebebebebebebebebebebebebebe
bebebebebebebebebebebebebebebebebebebebebebebebebebebebebebe
bebebebebebebebebebebebebebebebebebebebebebebebebebebebebebe
bebebebebebebebebebebebebebebebebebebebebebebebebebebebebebe
bebebebebebebebebebebebebebebebebebebebebebebebebebebebebebe
bebebebebebebebebebebebebebebebebebebebebebebebebebebebebebe
bebebebebebebebebebebebebebebebebebebebebebebebebebebebebebe
bebebebebebebebebebebebebebebebebebebebebebebebebebebebebebe
bebebebebebebebebebebebebebebebebebebebebebebebebebebebebebe
bebebebebebebebebebebebebebebebebebebebebebebebebebebebebebe
bebebebebebebebebebebebebebebebebebebebebebebebebebebebebebe
bebebebebebebebebebebebebebebebebebebebebebebebebebebebebebe
bebebebebebebebebebebebebebebebebebebebebebebebebebebebebebe
bebebebebebebebebebebebebebebebebebebebebebebebebebebebebebe
bebebebebebebebebebebebebebebebebebebebebebebebebebebebebebe
bebebebebebebebebebebebebebebebebebebebebebebebebebebebebebe
bebebebebebebebebebebebebebebebebebebebebebebebebebebebebebe
bebebebebebebebebebebebebebebebebebebebebebebebebebebebebebe
bebebebebebebebebebebebebebebebebebebebebebebebebebebebebebe
bebebebebebebebebebebebebebebebebebebebebebebebebebebebebebe
bebebebebebebebebebebebebebebebebebebebebebebebebebebebebebe
bebebebebebebebebebebebebebebebebebebebebebebebebebebebebebe
bebebebebebebebebebebebebebebebebebebebebebebebebebebebebebe
bebebebebebebebebebebebebebebebebebebebebebebebebebebebebebe
bebebebebebebebebebebebebebebebebebebebebebebebebebebebebebe
bebebebebebebebebebebebebebebebebebebebebebebebebebebebebebe
bebebebebebebebebebebebebebebebebebebebebebebebebebebebebebe
bebebebebebebebebebebebebebebebebebebebebebebebebebebebebebe
bebebebebebebebebebebebebebebebebebebebebebebebebebebebebebe
"}

(1,1,5) = {"
bebebebebebebebebebebebebebebebebebebebebebebebebebebebebebe
bebebebebebebebebebebebebebebebebebebebebebebebebebebebebebe
bebebebebebebebebebebebebebebebebebebebebebebebebebebebebebe
bebebebebebebebebebebebebebebebebebebebebebebebebebebebebebe
bebebebebebebebebebebebebebebebebebebebebebebebebebebebebebe
bebebebebebebebebebebebebebebebebebebebebebebebebebebebebebe
bebebebebebebebebebebebebebebebebebebebebebebebebebebebebebe
bebebebebebebebebebebebebebebebebebebebebebebebebebebebebebe
bebebebebebebebebebebebebebebebebebebebebebebebebebebebebebe
bebebebebebebebebebebebebebebebebebebebebebebebebebebebebebe
bebebebebebebebebebebebebebebebebebebebebebebebebebebebebebe
bebebebebebebebebebebebebebebebebebebebebebebebebebebebebebe
bebebebebebebebebebebebebebebebebebebebebebebebebebebebebebe
bebebebebebebebebebebebebebebebebebebebebebebebebebebebebebe
bebebebebebebebebebebebebebebebebebebebebebebebebebebebebebe
bebebebebebebebebebebebebebebebebebebebebebebebebebebebebebe
bebebebebebebebebebebebebebebebebebebebebebebebebebebebebebe
bebebebebebebebebebebebebebebebebebebebebebebebebebebebebebe
bebebebebebebebebebebebebebebebebebebebebebebebebebebebebebe
bebebebebebebebebebebebebebebebebebebebebebebebebebebebebebe
bebebebebebebebebebebebebebebebebebebebebebebebebebebebebebe
bebebebebebebebebebebebebebebebebebebebebebebebebebebebebebe
bebebebebebebebebebebebebebebebebebebebebebebebebebebebebebe
bebebebebebebebebebebebebebebebebebebebebebebebebebebebebebe
bebebebebebebebebebebebebebebebebebebebebebebebebebebebebebe
bebebebebebebebebebebebebebebebebebebebebebebebebebebebebebe
bebebebebebebebebebebebebebebebebebebebebebebebebebebebebebe
bebebebebebebebebebebebebebebebebebebebebebebebebebebebebebe
bebebebebebebebebebebebebebebebebebebebebebebebebebebebebebe
bebebebebebebebebebebebebebebebebebebebebebebebebebebebebebe
"}
