"aa" = (/turf/wall/generic,/area/underground)
"ab" = (/turf/floor/generic/wooden,/area/underground)
"ac" = (/obj/electricity/lightbulb/east,/turf/floor/generic/wooden,/area/underground)
"ad" = (/turf/floor/generic/white,/area/underground)
"ae" = (/obj/electricity/lightbulb/west,/turf/floor/generic/wooden,/area/underground)
"af" = (/obj/electricity/lightbulb,/turf/floor/generic/wooden,/area/underground)
"ag" = (/obj/electricity/machine/door,/turf/floor/generic/red,/area/underground)
"ah" = (/obj/electricity/lightbulb/north,/turf/floor/generic/red,/area/underground)
"ai" = (/turf/floor/generic/red,/area/underground)
"aj" = (/obj/electricity/lightswitch/east,/turf/floor/generic/wooden,/area/underground)
"ak" = (/obj/electricity/lightbulb,/turf/floor/generic/red,/area/underground)
"al" = (/obj/electricity/elevator/button/west,/turf/floor/generic/red,/area/underground)
"am" = (/obj/electricity/machine/door,/turf/floor/generic/black,/area/underground)
"an" = (/turf/wall/generic,/area/elevator)
"ao" = (/obj/electricity/machine/door/elevator_door,/turf/floor/generic/black,/area/elevator)
"ap" = (/turf/floor/generic/black,/area/underground)
"aq" = (/turf/floor/generic/chess,/area/underground)
"ar" = (/obj/electricity/elevator/button/east,/turf/floor/generic/chess,/area/underground)
"as" = (/turf/floor/generic/black,/area/elevator)
"at" = (/obj/electricity/elevator/controls/north,/turf/floor/generic/black,/area/elevator)
"au" = (/obj/electricity/elevator/button/west,/turf/floor/generic/chess,/area/underground)
"av" = (/obj/electricity/lightbulb,/turf/floor/generic/black,/area/underground)
"aw" = (/obj/electricity/lightbulb/west,/turf/floor/generic/chess,/area/underground)
"ax" = (/obj/electricity/lightbulb/east,/turf/floor/generic/chess,/area/underground)
"ay" = (/obj/electricity/lightbulb/west,/turf/floor/generic/black,/area/elevator)
"az" = (/obj/electricity/lightbulb/east,/turf/floor/generic/black,/area/elevator)
"aA" = (/obj/electricity/machine/door,/turf/floor/generic/chess,/area/underground)
"aB" = (/liquid,/turf/floor/generic/wooden,/area/underground)
"aC" = (/obj/item/ball,/turf/floor/generic/wooden,/area/underground)
"aD" = (/obj/electricity/lightbulb/north,/turf/floor/generic/wooden,/area/underground)
"aE" = (/obj/electricity/lightbulb/south,/turf/floor/generic/wooden,/area/underground)
"aF" = (/obj/electricity/elevator/button/south,/turf/floor/generic/wooden,/area/underground)
"aG" = (/turf/wall/generic,/area/elevator{name = "Elevator0"})
"aH" = (/obj/electricity/machine/door/elevator_door,/turf/floor/generic/black,/area/elevator{name = "Elevator0"})
"aI" = (/turf/floor/generic/black,/area/elevator{name = "Elevator0"})
"aJ" = (/obj/electricity/lightbulb/north,/turf/floor/generic/chess,/area/underground)
"aK" = (/obj/electricity/elevator/button/east,/turf/floor/generic/red,/area/underground)
"aL" = (/obj/electricity/lightbulb/south,/turf/floor/generic/chess,/area/underground)
"aM" = (/obj/electricity/elevator/button/north,/turf/floor/generic/white,/area/underground)
"aN" = (/obj/electricity/lightbulb,/turf/floor/generic/white,/area/underground)
"aO" = (/obj/electricity/lightbulb/south,/turf/floor/generic/red,/area/underground)
"aP" = (/obj/electricity/lightbulb/north,/turf/floor/generic/white,/area/underground)
"aQ" = (/obj/electricity/lightbulb/north,/turf/floor/generic,/area/underground)
"aR" = (/turf/floor/generic,/area/underground)
"aS" = (/obj/electricity/lightbulb/south,/turf/floor/generic,/area/underground)
"aT" = (/obj/electricity/lightbulb/east,/turf/floor/generic,/area/underground)
"aU" = (/obj/electricity/machine/door,/turf/floor/generic/wooden,/area/underground)
"aV" = (/obj/electricity/lightbulb/west,/turf/floor/generic,/area/underground)
"aW" = (/obj/electricity/lightbulb/south,/turf/floor/generic/white,/area/underground)
"aX" = (/obj/electricity/elevator/button/south,/turf/floor/generic/white,/area/underground)
"aY" = (/turf/wall/generic,/area/elevator{name = "Elevator1"})
"aZ" = (/obj/electricity/machine/door/elevator_door,/turf/floor/generic/black,/area/elevator{name = "Elevator1"})
"ba" = (/turf/floor/generic/black,/area/elevator{name = "Elevator1"})
"bb" = (/obj/electricity/elevator/button/south,/turf/floor/generic,/area/underground)
"bc" = (/obj/electricity/elevator/button/east,/turf/floor/generic,/area/underground)
"bd" = (/obj/electricity/elevator/button/north,/turf/floor/generic/chess,/area/underground)
"be" = (/obj/electricity/machine/door,/turf,/area/underground)
"bf" = (/obj/electricity/lightbulb/south,/turf/floor/generic/black,/area/underground)
"bg" = (/turf,/area/underground)

(1,1,1) = {"
aaaaaaaaaaaaaaaaaaaaaaaaaaaaaaaaaaaaaaaaaaaaaaaaaaaaaaaaaaaa
aaababababababababababababacaaaaadadadadadadadadadadadadadaa
aaaeabababababababababababacaaaaadadadadadadadadadadadadadaa
aaabababababafababababacaaaaaaaaaaaaadadadadadadadadadadadaa
aaabababababababababababagahaiaiahagadadadadadadadadadadadaa
aaabababababababababababagaiaiaiaiagadadadadadadadadadadadaa
aaabababababababababababagaiaiaiaiagadadadadadadadadadadadaa
aaabababababafababababajaaaiaiaiaiaaadadadadadadadadadadadaa
aaaeabababababababababacaaakaiaiakaaadadadadadadadadadadadaa
aaabababababababababababaaalaiaiaiaaadadadadadadadadadadadaa
aaamaaaaaaaaaaaaaaaaanananaoaoaoaoanananaaaaaaaaaaaaaaaaamaa
aaapaaaqaqaqaqaqaqaranasatasasasasasasanauaqaqaqaqaqaqaaapaa
aaavaaawaqaqaqaqaqaxanayasasasasasasazanawaqaqaqaqaqaqaaavaa
aaapaAaqaqaqaqaqaqaqaoasasasasasasasasaoaqaqaqaqaqaqaqaAapaa
aaapaaawaqaqaqaqaqaqaoasasasasasasasasaoaqaqaqaqaqaqaqaaapaa
aaavaaaqaqaqaqaqaqaxanayasasasasasasazanawaqaqaqaqaqaqaaavaa
aaapaaaqaqaqaqaqaqaqanasasasasasasasasanaqaqaqaqaqaqaqaaapaa
aaamaaaaaaaaaaaaaaaaanananaoaoaoaoanananaaaaaaaaaaaaaaaaamaa
aaabababababababababababaaalaiaiaiaaadadadadadadadadadadadaa
aaaBabababaCabaCababababaaaiaiaiaiaaadadadadadadadadadadadaa
aaabababababababababababaaaiaiaiaiaaadadadadadadadadadadadaa
aaabababafabaCabafabaBabaaaiaiaiaiaaadadadadadadadadadadadaa
aaabababababababababababaaaiaiaiaiaaadadadadadadadadadadadaa
aaababaBababaBabababababaaaiaiaiaiaaadadadadadadadadadadadaa
aaabababababababababababaaaiaiaiaiaaadadadadadadadadadadadaa
aaabababafabababafabababaaaiaiaiaiaaadadadadadadadadadadadaa
aaabababababababababababagaiaiaiaiagadadadadadadadadadadadaa
aaababababababaBababababagaiaiaiaiagadadadadadadadadadadadaa
aaabaBabababababababababagaiaiaiaiagadadadadadadadadadadadaa
aaaaaaaaaaaaaaaaaaaaaaaaaaaaaaaaaaaaaaaaaaaaaaaaaaaaaaaaaaaa
"}

(1,1,2) = {"
aaaaaaaaaaaaaaaaaaaaaaaaaaaaaaaaaaaaaaaaaaaaaaaaaaaaaaaaaaaa
aaabababaDababababababaDababababababaDababababababaDabababaa
aaababababababababababababababababababababababababababababaa
aaababababababababababababababababababababababababababababaa
aaababababababababababababababababababababababababababababaa
aaababababababababababababababababababababababababababababaa
aaababababababababababababababababababababababababababababaa
aaababababababababababababababababababababababababababababaa
aaababababababababababababababababababababababababababababaa
aaabababaEababababababaEaFabababababaEababababababaEabababaa
aaaaagagaaaaaaaaaaaaaGaGaGaHaHaHaHaGaGaGaaaaaaaaaaaaaAaAaaaa
aaaiaiaiaiaiaiaiaiaiaGaIaIaIaIaIaIaIaIaGaqaqaqaJaqaJaqaqaqaa
aaaiaiaiaiaiaiaiaiaKaGaIaIaIaIaIaIaIaIaGauaqaqaqaqaqaqaqaqaa
aaaiaiaiaiaiaiaiaiaiaHaIaIaIaIaIaIaIaIaHaqaqaqaqaqaqaqaqaqaa
aaaiaiaiakaiakaiaiaiaHaIaIaIaIaIaIaIaIaHaqaqaqaqaqaqaqaqaqaa
aaaiaiaiaiaiaiaiaiaiaGaIaIaIaIaIaIaIaIaGaqaqaqaqaqaqaqaqaqaa
aaaiaiaiaiaiaiaiaiaiaGaIaIaIaIaIaIaIaIaGaqaqaqaLaqaLaqaqaqaa
aaaiaiaiaiaiaiaiaiaiaGaGaGaHaHaHaHaGaGaGaaaaaaaaaaaaaAaAaaaa
aaaiaiaiaiaiaiaiaiaiaaadaMadadadadadadadadadadadadadadadadaa
aaaiaiaiaiaiaiaiaiaiaaadadadadadadadadadadadadadadadadadadaa
aaaiaiaiaiaiaiaiaiaiaaadadadadadadadadadadadadadadadadadadaa
aaaiaiaiaiaiaiaiaiaiaaadadadaNadadadaNadadaNadadadaNadadadaa
aaaiaiaiakaiakaiaiaiaaadadadadadadadadadadadadadadadadadadaa
aaaiaiaiaiaiaiaiaiaiaaadadadadadadadadadadadadadadadadadadaa
aaaiaiaiaiaiaiaiaiaiaaadadadadadadadadadadadadadadadadadadaa
aaaiaiaiaiaiaiaiaiaiaaadadadaNadadadaNadadaNadadadaNadadadaa
aaaiaiaiaiaiaiaiaiaiagadadadadadadadadadadadadadadadadadadaa
aaaiaiaiaiaiaiaiaiaiagadadadadadadadadadadadadadadadadadadaa
aaaiaiaiaOaiaOaiaiaiaaadadadadadadadadadadadadadadadadadadaa
aaaaaaaaaaaaaaaaaaaaaaaaaaaaaaaaaaaaaaaaaaaaaaaaaaaaaaaaaaaa
"}

(1,1,3) = {"
aaaaaaaaaaaaaaaaaaaaaaaaaaaaaaaaaaaaaaaaaaaaaaaaaaaaaaaaaaaa
aaadaPadadadadadaPadadaPadadadadadaPadaaaQaRaQaRaQaRaQaRaQaa
aaadadadadadadadadadadadadadadadadadadaaaRaRaSaRaSaRaSaRaTaa
aaadadadadadadadadadadadadadadadadadadaaaUaUaaaaaaaaaaaRaRaa
aaadadadadadadadadadadadadadadadadadadaaababababababaaaVaTaa
aaadadadadadadadadadadadadadadadadadadaaaeababababacaaaRaRaa
aaadadadadadadadadadadadadadadadadadadaaababababababaaaVaTaa
aaadadadadadadadadadadadadadadadadadadaaababababababaaaRaRaa
aaadadadadadadadadadadadadadadadadadadaaababababababaaaVaTaa
aaadaWadadadadadaWadadaWaXadadadadaWadaaababababababaaaRaRaa
aaaaaaaaaaaaaaaaaaaaaYaYaYaZaZaZaZaYaYaYaeababababacaaaVaTaa
aaaRaRaRaRaRaRaRaRaRaYbabababababababaaYababababababaaaRaRaa
aaaVaRaRaRaRaRaRaRaTaYbabababababababaaYaaaaaaaaaaaaaaaVaTaa
aaaRaRaRaRaRaRaRaRaRaZbabababababababaaZaRaQaRaQaRaQaRaRaRaa
aaaRaRaRaRaRaRaRaRaRaZbabababababababaaZbbaSaRaSaRaSaRaRaRaa
aaaRaRaRaRaRaRaRaRbcaYbabababababababaaYaaaaaaaaaaaaaaagagaa
aaaRaRaRaRaRaRaRaRaRaYbabababababababaaYaiaiaiaiaiaiaiaiaiaa
aaaRaRaRaRaRaRaRaRaRaYaYaYaZaZaZaZaYaYaYaiaiaiaiaiaiaiaiaiaa
aaaRaRaRaRaRaRaRaRaRaaawbdaqaqaqaqaqaxaaaiaiaiaiaiaiaiaiaiaa
aaaRaRaRaRaRaRaRaRaRaaaqaqaqaqaqaqaqaqagaiaiaiaiaiaiaiaiaiaa
aaaVaRaRaRaRaRaRaRaTaaaqaqaqaqaqaqaqaqagaiaiaiaiaiaiaiaiaiaa
aaaRaRaRaRaRaRaRaRaRaaawaqaqaqaqaqaqaxaaaiaiaiaiaiaiaiaiaiaa
aaaRaRaRaRaRaRaRaRaRaaaaaaaaaaaaaaaaaaaaaaaaaaaaaaaaaaaaaaaa
aaaRaRaRaRaRaRaRaRaRaaapadapaPapadapadapaPapadapadapaPapadaa
aaaRaRaRaRaRaRaRaRaRaaadapadapadapadapadapadapadapadapadapaa
aaaRaRaRaRaRaRaRaRaRbeapadapadapadapadapadapadapadapadapadaa
aaaRaRaRaRaRaRaRaRaRbeadapadapadapadapadapadapadapadapadapaa
aaaVaRaRaRaRaRaRaRaTaaapadapadapadapadapadapadapadapadapadaa
aaaRaRaRaRaRaRaRaRaRaaadapadbfadapadapadbfadapadapadbfadapaa
aaaaaaaaaaaaaaaaaaaaaaaaaaaaaaaaaaaaaaaaaaaaaaaaaaaaaaaaaaaa
"}

(1,1,4) = {"
bgbgbgbgbgbgbgbgbgbgbgbgbgbgbgbgbgbgbgbgbgbgbgbgbgbgbgbgbgbg
bgbgbgbgbgbgbgbgbgbgbgbgbgbgbgbgbgbgbgbgbgbgbgbgbgbgbgbgbgbg
bgbgbgbgbgbgbgbgbgbgbgbgbgbgbgbgbgbgbgbgbgbgbgbgbgbgbgbgbgbg
bgbgbgbgbgbgbgbgbgbgbgbgbgbgbgbgbgbgbgbgbgbgbgbgbgbgbgbgbgbg
bgbgbgbgbgbgbgbgbgbgbgbgbgbgbgbgbgbgbgbgbgbgbgbgbgbgbgbgbgbg
bgbgbgbgbgbgbgbgbgbgbgbgbgbgbgbgbgbgbgbgbgbgbgbgbgbgbgbgbgbg
bgbgbgbgbgbgbgbgbgbgbgbgbgbgbgbgbgbgbgbgbgbgbgbgbgbgbgbgbgbg
bgbgbgbgbgbgbgbgbgbgbgbgbgbgbgbgbgbgbgbgbgbgbgbgbgbgbgbgbgbg
bgbgbgbgbgbgbgbgbgbgbgbgbgbgbgbgbgbgbgbgbgbgbgbgbgbgbgbgbgbg
bgbgbgbgbgbgbgbgbgbgbgbgbgbgbgbgbgbgbgbgbgbgbgbgbgbgbgbgbgbg
bgbgbgbgbgbgbgbgbgbgbgbgbgbgbgbgbgbgbgbgbgbgbgbgbgbgbgbgbgbg
bgbgbgbgbgbgbgbgbgbgbgbgbgbgbgbgbgbgbgbgbgbgbgbgbgbgbgbgbgbg
bgbgbgbgbgbgbgbgbgbgbgbgbgbgbgbgbgbgbgbgbgbgbgbgbgbgbgbgbgbg
bgbgbgbgbgbgbgbgbgbgbgbgbgbgbgbgbgbgbgbgbgbgbgbgbgbgbgbgbgbg
bgbgbgbgbgbgbgbgbgbgbgbgbgbgbgbgbgbgbgbgbgbgbgbgbgbgbgbgbgbg
bgbgbgbgbgbgbgbgbgbgbgbgbgbgbgbgbgbgbgbgbgbgbgbgbgbgbgbgbgbg
bgbgbgbgbgbgbgbgbgbgbgbgbgbgbgbgbgbgbgbgbgbgbgbgbgbgbgbgbgbg
bgbgbgbgbgbgbgbgbgbgbgbgbgbgbgbgbgbgbgbgbgbgbgbgbgbgbgbgbgbg
bgbgbgbgbgbgbgbgbgbgbgbgbgbgbgbgbgbgbgbgbgbgbgbgbgbgbgbgbgbg
bgbgbgbgbgbgbgbgbgbgbgbgbgbgbgbgbgbgbgbgbgbgbgbgbgbgbgbgbgbg
bgbgbgbgbgbgbgbgbgbgbgbgbgbgbgbgbgbgbgbgbgbgbgbgbgbgbgbgbgbg
bgbgbgbgbgbgbgbgbgbgbgbgbgbgbgbgbgbgbgbgbgbgbgbgbgbgbgbgbgbg
bgbgbgbgbgbgbgbgbgbgbgbgbgbgbgbgbgbgbgbgbgbgbgbgbgbgbgbgbgbg
bgbgbgbgbgbgbgbgbgbgbgbgbgbgbgbgbgbgbgbgbgbgbgbgbgbgbgbgbgbg
bgbgbgbgbgbgbgbgbgbgbgbgbgbgbgbgbgbgbgbgbgbgbgbgbgbgbgbgbgbg
bgbgbgbgbgbgbgbgbgbgbgbgbgbgbgbgbgbgbgbgbgbgbgbgbgbgbgbgbgbg
bgbgbgbgbgbgbgbgbgbgbgbgbgbgbgbgbgbgbgbgbgbgbgbgbgbgbgbgbgbg
bgbgbgbgbgbgbgbgbgbgbgbgbgbgbgbgbgbgbgbgbgbgbgbgbgbgbgbgbgbg
bgbgbgbgbgbgbgbgbgbgbgbgbgbgbgbgbgbgbgbgbgbgbgbgbgbgbgbgbgbg
bgbgbgbgbgbgbgbgbgbgbgbgbgbgbgbgbgbgbgbgbgbgbgbgbgbgbgbgbgbg
"}

(1,1,5) = {"
bgbgbgbgbgbgbgbgbgbgbgbgbgbgbgbgbgbgbgbgbgbgbgbgbgbgbgbgbgbg
bgbgbgbgbgbgbgbgbgbgbgbgbgbgbgbgbgbgbgbgbgbgbgbgbgbgbgbgbgbg
bgbgbgbgbgbgbgbgbgbgbgbgbgbgbgbgbgbgbgbgbgbgbgbgbgbgbgbgbgbg
bgbgbgbgbgbgbgbgbgbgbgbgbgbgbgbgbgbgbgbgbgbgbgbgbgbgbgbgbgbg
bgbgbgbgbgbgbgbgbgbgbgbgbgbgbgbgbgbgbgbgbgbgbgbgbgbgbgbgbgbg
bgbgbgbgbgbgbgbgbgbgbgbgbgbgbgbgbgbgbgbgbgbgbgbgbgbgbgbgbgbg
bgbgbgbgbgbgbgbgbgbgbgbgbgbgbgbgbgbgbgbgbgbgbgbgbgbgbgbgbgbg
bgbgbgbgbgbgbgbgbgbgbgbgbgbgbgbgbgbgbgbgbgbgbgbgbgbgbgbgbgbg
bgbgbgbgbgbgbgbgbgbgbgbgbgbgbgbgbgbgbgbgbgbgbgbgbgbgbgbgbgbg
bgbgbgbgbgbgbgbgbgbgbgbgbgbgbgbgbgbgbgbgbgbgbgbgbgbgbgbgbgbg
bgbgbgbgbgbgbgbgbgbgbgbgbgbgbgbgbgbgbgbgbgbgbgbgbgbgbgbgbgbg
bgbgbgbgbgbgbgbgbgbgbgbgbgbgbgbgbgbgbgbgbgbgbgbgbgbgbgbgbgbg
bgbgbgbgbgbgbgbgbgbgbgbgbgbgbgbgbgbgbgbgbgbgbgbgbgbgbgbgbgbg
bgbgbgbgbgbgbgbgbgbgbgbgbgbgbgbgbgbgbgbgbgbgbgbgbgbgbgbgbgbg
bgbgbgbgbgbgbgbgbgbgbgbgbgbgbgbgbgbgbgbgbgbgbgbgbgbgbgbgbgbg
bgbgbgbgbgbgbgbgbgbgbgbgbgbgbgbgbgbgbgbgbgbgbgbgbgbgbgbgbgbg
bgbgbgbgbgbgbgbgbgbgbgbgbgbgbgbgbgbgbgbgbgbgbgbgbgbgbgbgbgbg
bgbgbgbgbgbgbgbgbgbgbgbgbgbgbgbgbgbgbgbgbgbgbgbgbgbgbgbgbgbg
bgbgbgbgbgbgbgbgbgbgbgbgbgbgbgbgbgbgbgbgbgbgbgbgbgbgbgbgbgbg
bgbgbgbgbgbgbgbgbgbgbgbgbgbgbgbgbgbgbgbgbgbgbgbgbgbgbgbgbgbg
bgbgbgbgbgbgbgbgbgbgbgbgbgbgbgbgbgbgbgbgbgbgbgbgbgbgbgbgbgbg
bgbgbgbgbgbgbgbgbgbgbgbgbgbgbgbgbgbgbgbgbgbgbgbgbgbgbgbgbgbg
bgbgbgbgbgbgbgbgbgbgbgbgbgbgbgbgbgbgbgbgbgbgbgbgbgbgbgbgbgbg
bgbgbgbgbgbgbgbgbgbgbgbgbgbgbgbgbgbgbgbgbgbgbgbgbgbgbgbgbgbg
bgbgbgbgbgbgbgbgbgbgbgbgbgbgbgbgbgbgbgbgbgbgbgbgbgbgbgbgbgbg
bgbgbgbgbgbgbgbgbgbgbgbgbgbgbgbgbgbgbgbgbgbgbgbgbgbgbgbgbgbg
bgbgbgbgbgbgbgbgbgbgbgbgbgbgbgbgbgbgbgbgbgbgbgbgbgbgbgbgbgbg
bgbgbgbgbgbgbgbgbgbgbgbgbgbgbgbgbgbgbgbgbgbgbgbgbgbgbgbgbgbg
bgbgbgbgbgbgbgbgbgbgbgbgbgbgbgbgbgbgbgbgbgbgbgbgbgbgbgbgbgbg
bgbgbgbgbgbgbgbgbgbgbgbgbgbgbgbgbgbgbgbgbgbgbgbgbgbgbgbgbgbg
"}
