"aa" = (/turf/wall/generic,/area/underground)
"ab" = (/turf/floor/generic/wooden,/area/underground)
"ac" = (/obj/electricity/lightbulb/east,/turf/floor/generic/wooden,/area/underground)
"ad" = (/turf/floor/generic/white,/area/underground)
"ae" = (/obj/electricity/lightbulb/west,/turf/floor/generic/wooden,/area/underground)
"af" = (/obj/electricity/lightbulb,/turf/floor/generic/wooden,/area/underground)
"ag" = (/obj/electricity/machine/door,/turf/floor/generic/red,/area/underground)
"ah" = (/obj/electricity/lightbulb/north,/turf/floor/generic/red,/area/underground)
"ai" = (/turf/floor/generic/red,/area/underground)
"aj" = (/obj/electricity/lightswitch/east,/turf/floor/generic/wooden,/area/underground)
"ak" = (/obj/electricity/lightbulb,/turf/floor/generic/red,/area/underground)
"al" = (/obj/electricity/elevator/button/west,/turf/floor/generic/red,/area/underground)
"am" = (/obj/electricity/machine/door,/turf/floor/generic/black,/area/underground)
"an" = (/turf/wall/generic,/area/elevator)
"ao" = (/obj/electricity/machine/door/elevator_door,/turf/floor/generic/black,/area/elevator)
"ap" = (/turf/floor/generic/black,/area/underground)
"aq" = (/turf/floor/generic/chess,/area/underground)
"ar" = (/obj/electricity/elevator/button/east,/turf/floor/generic/chess,/area/underground)
"as" = (/turf/floor/generic/black,/area/elevator)
"at" = (/obj/electricity/elevator/controls/north,/turf/floor/generic/black,/area/elevator)
"au" = (/obj/electricity/elevator/button/west,/turf/floor/generic/chess,/area/underground)
"av" = (/obj/electricity/lightbulb,/turf/floor/generic/black,/area/underground)
"aw" = (/obj/electricity/lightbulb/west,/turf/floor/generic/chess,/area/underground)
"ax" = (/obj/electricity/lightbulb/east,/turf/floor/generic/chess,/area/underground)
"ay" = (/obj/electricity/lightbulb/west,/turf/floor/generic/black,/area/elevator)
"az" = (/obj/electricity/lightbulb/east,/turf/floor/generic/black,/area/elevator)
"aA" = (/obj/electricity/machine/door,/turf/floor/generic/chess,/area/underground)
"aB" = (/obj/item/ball,/turf/floor/generic/wooden,/area/underground)
"aC" = (/obj/electricity/lightbulb/north,/turf/floor/generic/wooden,/area/underground)
"aD" = (/obj/electricity/lightbulb/south,/turf/floor/generic/wooden,/area/underground)
"aE" = (/obj/electricity/elevator/button/south,/turf/floor/generic/wooden,/area/underground)
"aF" = (/turf/wall/generic,/area/elevator{name = "Elevator0"})
"aG" = (/obj/electricity/machine/door/elevator_door,/turf/floor/generic/black,/area/elevator{name = "Elevator0"})
"aH" = (/turf/floor/generic/black,/area/elevator{name = "Elevator0"})
"aI" = (/obj/electricity/lightbulb/north,/turf/floor/generic/chess,/area/underground)
"aJ" = (/obj/electricity/elevator/button/east,/turf/floor/generic/red,/area/underground)
"aK" = (/obj/electricity/lightbulb/south,/turf/floor/generic/chess,/area/underground)
"aL" = (/obj/electricity/elevator/button/north,/turf/floor/generic/white,/area/underground)
"aM" = (/obj/electricity/lightbulb,/turf/floor/generic/white,/area/underground)
"aN" = (/obj/electricity/lightbulb/south,/turf/floor/generic/red,/area/underground)
"aO" = (/obj/electricity/lightbulb/north,/turf/floor/generic/white,/area/underground)
"aP" = (/obj/electricity/lightbulb/north,/turf/floor/generic,/area/underground)
"aQ" = (/turf/floor/generic,/area/underground)
"aR" = (/obj/electricity/lightbulb/south,/turf/floor/generic,/area/underground)
"aS" = (/obj/electricity/lightbulb/east,/turf/floor/generic,/area/underground)
"aT" = (/obj/electricity/machine/door,/turf/floor/generic/wooden,/area/underground)
"aU" = (/obj/electricity/lightbulb/west,/turf/floor/generic,/area/underground)
"aV" = (/obj/electricity/lightbulb/south,/turf/floor/generic/white,/area/underground)
"aW" = (/obj/electricity/elevator/button/south,/turf/floor/generic/white,/area/underground)
"aX" = (/turf/wall/generic,/area/elevator{name = "Elevator1"})
"aY" = (/obj/electricity/machine/door/elevator_door,/turf/floor/generic/black,/area/elevator{name = "Elevator1"})
"aZ" = (/turf/floor/generic/black,/area/elevator{name = "Elevator1"})
"ba" = (/obj/electricity/elevator/button/south,/turf/floor/generic,/area/underground)
"bb" = (/obj/electricity/elevator/button/east,/turf/floor/generic,/area/underground)
"bc" = (/obj/electricity/elevator/button/north,/turf/floor/generic/chess,/area/underground)
"bd" = (/obj/electricity/machine/door,/turf,/area/underground)
"be" = (/obj/electricity/lightbulb/south,/turf/floor/generic/black,/area/underground)
"bf" = (/turf,/area/underground)

(1,1,1) = {"
aaaaaaaaaaaaaaaaaaaaaaaaaaaaaaaaaaaaaaaaaaaaaaaaaaaaaaaaaaaa
aaababababababababababababacaaaaadadadadadadadadadadadadadaa
aaaeabababababababababababacaaaaadadadadadadadadadadadadadaa
aaabababababafababababacaaaaaaaaaaaaadadadadadadadadadadadaa
aaabababababababababababagahaiaiahagadadadadadadadadadadadaa
aaabababababababababababagaiaiaiaiagadadadadadadadadadadadaa
aaabababababababababababagaiaiaiaiagadadadadadadadadadadadaa
aaabababababafababababajaaaiaiaiaiaaadadadadadadadadadadadaa
aaaeabababababababababacaaakaiaiakaaadadadadadadadadadadadaa
aaabababababababababababaaalaiaiaiaaadadadadadadadadadadadaa
aaamaaaaaaaaaaaaaaaaanananaoaoaoaoanananaaaaaaaaaaaaaaaaamaa
aaapaaaqaqaqaqaqaqaranasatasasasasasasanauaqaqaqaqaqaqaaapaa
aaavaaawaqaqaqaqaqaxanayasasasasasasazanawaqaqaqaqaqaqaaavaa
aaapaAaqaqaqaqaqaqaqaoasasasasasasasasaoaqaqaqaqaqaqaqaAapaa
aaapaaawaqaqaqaqaqaqaoasasasasasasasasaoaqaqaqaqaqaqaqaaapaa
aaavaaaqaqaqaqaqaqaxanayasasasasasasazanawaqaqaqaqaqaqaaavaa
aaapaaaqaqaqaqaqaqaqanasasasasasasasasanaqaqaqaqaqaqaqaaapaa
aaamaaaaaaaaaaaaaaaaanananaoaoaoaoanananaaaaaaaaaaaaaaaaamaa
aaabababababababababababaaalaiaiaiaaadadadadadadadadadadadaa
aaababababaBabaBababababaaaiaiaiaiaaadadadadadadadadadadadaa
aaabababababababababababaaaiaiaiaiaaadadadadadadadadadadadaa
aaabababafabaBabafabababaaaiaiaiaiaaadadadadadadadadadadadaa
aaabababababababababababaaaiaiaiaiaaadadadadadadadadadadadaa
aaabababababababababababaaaiaiaiaiaaadadadadadadadadadadadaa
aaabababababababababababaaaiaiaiaiaaadadadadadadadadadadadaa
aaabababafabababafabababaaaiaiaiaiaaadadadadadadadadadadadaa
aaabababababababababababagaiaiaiaiagadadadadadadadadadadadaa
aaabababababababababababagaiaiaiaiagadadadadadadadadadadadaa
aaabababababababababababagaiaiaiaiagadadadadadadadadadadadaa
aaaaaaaaaaaaaaaaaaaaaaaaaaaaaaaaaaaaaaaaaaaaaaaaaaaaaaaaaaaa
"}

(1,1,2) = {"
aaaaaaaaaaaaaaaaaaaaaaaaaaaaaaaaaaaaaaaaaaaaaaaaaaaaaaaaaaaa
aaabababaCababababababaCababababababaCababababababaCabababaa
aaababababababababababababababababababababababababababababaa
aaababababababababababababababababababababababababababababaa
aaababababababababababababababababababababababababababababaa
aaababababababababababababababababababababababababababababaa
aaababababababababababababababababababababababababababababaa
aaababababababababababababababababababababababababababababaa
aaababababababababababababababababababababababababababababaa
aaabababaDababababababaDaEabababababaDababababababaDabababaa
aaaaagagaaaaaaaaaaaaaFaFaFaGaGaGaGaFaFaFaaaaaaaaaaaaaAaAaaaa
aaaiaiaiaiaiaiaiaiaiaFaHaHaHaHaHaHaHaHaFaqaqaqaIaqaIaqaqaqaa
aaaiaiaiaiaiaiaiaiaJaFaHaHaHaHaHaHaHaHaFauaqaqaqaqaqaqaqaqaa
aaaiaiaiaiaiaiaiaiaiaGaHaHaHaHaHaHaHaHaGaqaqaqaqaqaqaqaqaqaa
aaaiaiaiakaiakaiaiaiaGaHaHaHaHaHaHaHaHaGaqaqaqaqaqaqaqaqaqaa
aaaiaiaiaiaiaiaiaiaiaFaHaHaHaHaHaHaHaHaFaqaqaqaqaqaqaqaqaqaa
aaaiaiaiaiaiaiaiaiaiaFaHaHaHaHaHaHaHaHaFaqaqaqaKaqaKaqaqaqaa
aaaiaiaiaiaiaiaiaiaiaFaFaFaGaGaGaGaFaFaFaaaaaaaaaaaaaAaAaaaa
aaaiaiaiaiaiaiaiaiaiaaadaLadadadadadadadadadadadadadadadadaa
aaaiaiaiaiaiaiaiaiaiaaadadadadadadadadadadadadadadadadadadaa
aaaiaiaiaiaiaiaiaiaiaaadadadadadadadadadadadadadadadadadadaa
aaaiaiaiaiaiaiaiaiaiaaadadadaMadadadaMadadaMadadadaMadadadaa
aaaiaiaiakaiakaiaiaiaaadadadadadadadadadadadadadadadadadadaa
aaaiaiaiaiaiaiaiaiaiaaadadadadadadadadadadadadadadadadadadaa
aaaiaiaiaiaiaiaiaiaiaaadadadadadadadadadadadadadadadadadadaa
aaaiaiaiaiaiaiaiaiaiaaadadadaMadadadaMadadaMadadadaMadadadaa
aaaiaiaiaiaiaiaiaiaiagadadadadadadadadadadadadadadadadadadaa
aaaiaiaiaiaiaiaiaiaiagadadadadadadadadadadadadadadadadadadaa
aaaiaiaiaNaiaNaiaiaiaaadadadadadadadadadadadadadadadadadadaa
aaaaaaaaaaaaaaaaaaaaaaaaaaaaaaaaaaaaaaaaaaaaaaaaaaaaaaaaaaaa
"}

(1,1,3) = {"
aaaaaaaaaaaaaaaaaaaaaaaaaaaaaaaaaaaaaaaaaaaaaaaaaaaaaaaaaaaa
aaadaOadadadadadaOadadaOadadadadadaOadaaaPaQaPaQaPaQaPaQaPaa
aaadadadadadadadadadadadadadadadadadadaaaQaQaRaQaRaQaRaQaSaa
aaadadadadadadadadadadadadadadadadadadaaaTaTaaaaaaaaaaaQaQaa
aaadadadadadadadadadadadadadadadadadadaaababababababaaaUaSaa
aaadadadadadadadadadadadadadadadadadadaaaeababababacaaaQaQaa
aaadadadadadadadadadadadadadadadadadadaaababababababaaaUaSaa
aaadadadadadadadadadadadadadadadadadadaaababababababaaaQaQaa
aaadadadadadadadadadadadadadadadadadadaaababababababaaaUaSaa
aaadaVadadadadadaVadadaVaWadadadadaVadaaababababababaaaQaQaa
aaaaaaaaaaaaaaaaaaaaaXaXaXaYaYaYaYaXaXaXaeababababacaaaUaSaa
aaaQaQaQaQaQaQaQaQaQaXaZaZaZaZaZaZaZaZaXababababababaaaQaQaa
aaaUaQaQaQaQaQaQaQaSaXaZaZaZaZaZaZaZaZaXaaaaaaaaaaaaaaaUaSaa
aaaQaQaQaQaQaQaQaQaQaYaZaZaZaZaZaZaZaZaYaQaPaQaPaQaPaQaQaQaa
aaaQaQaQaQaQaQaQaQaQaYaZaZaZaZaZaZaZaZaYbaaRaQaRaQaRaQaQaQaa
aaaQaQaQaQaQaQaQaQbbaXaZaZaZaZaZaZaZaZaXaaaaaaaaaaaaaaagagaa
aaaQaQaQaQaQaQaQaQaQaXaZaZaZaZaZaZaZaZaXaiaiaiaiaiaiaiaiaiaa
aaaQaQaQaQaQaQaQaQaQaXaXaXaYaYaYaYaXaXaXaiaiaiaiaiaiaiaiaiaa
aaaQaQaQaQaQaQaQaQaQaaawbcaqaqaqaqaqaxaaaiaiaiaiaiaiaiaiaiaa
aaaQaQaQaQaQaQaQaQaQaaaqaqaqaqaqaqaqaqagaiaiaiaiaiaiaiaiaiaa
aaaUaQaQaQaQaQaQaQaSaaaqaqaqaqaqaqaqaqagaiaiaiaiaiaiaiaiaiaa
aaaQaQaQaQaQaQaQaQaQaaawaqaqaqaqaqaqaxaaaiaiaiaiaiaiaiaiaiaa
aaaQaQaQaQaQaQaQaQaQaaaaaaaaaaaaaaaaaaaaaaaaaaaaaaaaaaaaaaaa
aaaQaQaQaQaQaQaQaQaQaaapadapaOapadapadapaOapadapadapaOapadaa
aaaQaQaQaQaQaQaQaQaQaaadapadapadapadapadapadapadapadapadapaa
aaaQaQaQaQaQaQaQaQaQbdapadapadapadapadapadapadapadapadapadaa
aaaQaQaQaQaQaQaQaQaQbdadapadapadapadapadapadapadapadapadapaa
aaaUaQaQaQaQaQaQaQaSaaapadapadapadapadapadapadapadapadapadaa
aaaQaQaQaQaQaQaQaQaQaaadapadbeadapadapadbeadapadapadbeadapaa
aaaaaaaaaaaaaaaaaaaaaaaaaaaaaaaaaaaaaaaaaaaaaaaaaaaaaaaaaaaa
"}

(1,1,4) = {"
bfbfbfbfbfbfbfbfbfbfbfbfbfbfbfbfbfbfbfbfbfbfbfbfbfbfbfbfbfbf
bfbfbfbfbfbfbfbfbfbfbfbfbfbfbfbfbfbfbfbfbfbfbfbfbfbfbfbfbfbf
bfbfbfbfbfbfbfbfbfbfbfbfbfbfbfbfbfbfbfbfbfbfbfbfbfbfbfbfbfbf
bfbfbfbfbfbfbfbfbfbfbfbfbfbfbfbfbfbfbfbfbfbfbfbfbfbfbfbfbfbf
bfbfbfbfbfbfbfbfbfbfbfbfbfbfbfbfbfbfbfbfbfbfbfbfbfbfbfbfbfbf
bfbfbfbfbfbfbfbfbfbfbfbfbfbfbfbfbfbfbfbfbfbfbfbfbfbfbfbfbfbf
bfbfbfbfbfbfbfbfbfbfbfbfbfbfbfbfbfbfbfbfbfbfbfbfbfbfbfbfbfbf
bfbfbfbfbfbfbfbfbfbfbfbfbfbfbfbfbfbfbfbfbfbfbfbfbfbfbfbfbfbf
bfbfbfbfbfbfbfbfbfbfbfbfbfbfbfbfbfbfbfbfbfbfbfbfbfbfbfbfbfbf
bfbfbfbfbfbfbfbfbfbfbfbfbfbfbfbfbfbfbfbfbfbfbfbfbfbfbfbfbfbf
bfbfbfbfbfbfbfbfbfbfbfbfbfbfbfbfbfbfbfbfbfbfbfbfbfbfbfbfbfbf
bfbfbfbfbfbfbfbfbfbfbfbfbfbfbfbfbfbfbfbfbfbfbfbfbfbfbfbfbfbf
bfbfbfbfbfbfbfbfbfbfbfbfbfbfbfbfbfbfbfbfbfbfbfbfbfbfbfbfbfbf
bfbfbfbfbfbfbfbfbfbfbfbfbfbfbfbfbfbfbfbfbfbfbfbfbfbfbfbfbfbf
bfbfbfbfbfbfbfbfbfbfbfbfbfbfbfbfbfbfbfbfbfbfbfbfbfbfbfbfbfbf
bfbfbfbfbfbfbfbfbfbfbfbfbfbfbfbfbfbfbfbfbfbfbfbfbfbfbfbfbfbf
bfbfbfbfbfbfbfbfbfbfbfbfbfbfbfbfbfbfbfbfbfbfbfbfbfbfbfbfbfbf
bfbfbfbfbfbfbfbfbfbfbfbfbfbfbfbfbfbfbfbfbfbfbfbfbfbfbfbfbfbf
bfbfbfbfbfbfbfbfbfbfbfbfbfbfbfbfbfbfbfbfbfbfbfbfbfbfbfbfbfbf
bfbfbfbfbfbfbfbfbfbfbfbfbfbfbfbfbfbfbfbfbfbfbfbfbfbfbfbfbfbf
bfbfbfbfbfbfbfbfbfbfbfbfbfbfbfbfbfbfbfbfbfbfbfbfbfbfbfbfbfbf
bfbfbfbfbfbfbfbfbfbfbfbfbfbfbfbfbfbfbfbfbfbfbfbfbfbfbfbfbfbf
bfbfbfbfbfbfbfbfbfbfbfbfbfbfbfbfbfbfbfbfbfbfbfbfbfbfbfbfbfbf
bfbfbfbfbfbfbfbfbfbfbfbfbfbfbfbfbfbfbfbfbfbfbfbfbfbfbfbfbfbf
bfbfbfbfbfbfbfbfbfbfbfbfbfbfbfbfbfbfbfbfbfbfbfbfbfbfbfbfbfbf
bfbfbfbfbfbfbfbfbfbfbfbfbfbfbfbfbfbfbfbfbfbfbfbfbfbfbfbfbfbf
bfbfbfbfbfbfbfbfbfbfbfbfbfbfbfbfbfbfbfbfbfbfbfbfbfbfbfbfbfbf
bfbfbfbfbfbfbfbfbfbfbfbfbfbfbfbfbfbfbfbfbfbfbfbfbfbfbfbfbfbf
bfbfbfbfbfbfbfbfbfbfbfbfbfbfbfbfbfbfbfbfbfbfbfbfbfbfbfbfbfbf
bfbfbfbfbfbfbfbfbfbfbfbfbfbfbfbfbfbfbfbfbfbfbfbfbfbfbfbfbfbf
"}

(1,1,5) = {"
bfbfbfbfbfbfbfbfbfbfbfbfbfbfbfbfbfbfbfbfbfbfbfbfbfbfbfbfbfbf
bfbfbfbfbfbfbfbfbfbfbfbfbfbfbfbfbfbfbfbfbfbfbfbfbfbfbfbfbfbf
bfbfbfbfbfbfbfbfbfbfbfbfbfbfbfbfbfbfbfbfbfbfbfbfbfbfbfbfbfbf
bfbfbfbfbfbfbfbfbfbfbfbfbfbfbfbfbfbfbfbfbfbfbfbfbfbfbfbfbfbf
bfbfbfbfbfbfbfbfbfbfbfbfbfbfbfbfbfbfbfbfbfbfbfbfbfbfbfbfbfbf
bfbfbfbfbfbfbfbfbfbfbfbfbfbfbfbfbfbfbfbfbfbfbfbfbfbfbfbfbfbf
bfbfbfbfbfbfbfbfbfbfbfbfbfbfbfbfbfbfbfbfbfbfbfbfbfbfbfbfbfbf
bfbfbfbfbfbfbfbfbfbfbfbfbfbfbfbfbfbfbfbfbfbfbfbfbfbfbfbfbfbf
bfbfbfbfbfbfbfbfbfbfbfbfbfbfbfbfbfbfbfbfbfbfbfbfbfbfbfbfbfbf
bfbfbfbfbfbfbfbfbfbfbfbfbfbfbfbfbfbfbfbfbfbfbfbfbfbfbfbfbfbf
bfbfbfbfbfbfbfbfbfbfbfbfbfbfbfbfbfbfbfbfbfbfbfbfbfbfbfbfbfbf
bfbfbfbfbfbfbfbfbfbfbfbfbfbfbfbfbfbfbfbfbfbfbfbfbfbfbfbfbfbf
bfbfbfbfbfbfbfbfbfbfbfbfbfbfbfbfbfbfbfbfbfbfbfbfbfbfbfbfbfbf
bfbfbfbfbfbfbfbfbfbfbfbfbfbfbfbfbfbfbfbfbfbfbfbfbfbfbfbfbfbf
bfbfbfbfbfbfbfbfbfbfbfbfbfbfbfbfbfbfbfbfbfbfbfbfbfbfbfbfbfbf
bfbfbfbfbfbfbfbfbfbfbfbfbfbfbfbfbfbfbfbfbfbfbfbfbfbfbfbfbfbf
bfbfbfbfbfbfbfbfbfbfbfbfbfbfbfbfbfbfbfbfbfbfbfbfbfbfbfbfbfbf
bfbfbfbfbfbfbfbfbfbfbfbfbfbfbfbfbfbfbfbfbfbfbfbfbfbfbfbfbfbf
bfbfbfbfbfbfbfbfbfbfbfbfbfbfbfbfbfbfbfbfbfbfbfbfbfbfbfbfbfbf
bfbfbfbfbfbfbfbfbfbfbfbfbfbfbfbfbfbfbfbfbfbfbfbfbfbfbfbfbfbf
bfbfbfbfbfbfbfbfbfbfbfbfbfbfbfbfbfbfbfbfbfbfbfbfbfbfbfbfbfbf
bfbfbfbfbfbfbfbfbfbfbfbfbfbfbfbfbfbfbfbfbfbfbfbfbfbfbfbfbfbf
bfbfbfbfbfbfbfbfbfbfbfbfbfbfbfbfbfbfbfbfbfbfbfbfbfbfbfbfbfbf
bfbfbfbfbfbfbfbfbfbfbfbfbfbfbfbfbfbfbfbfbfbfbfbfbfbfbfbfbfbf
bfbfbfbfbfbfbfbfbfbfbfbfbfbfbfbfbfbfbfbfbfbfbfbfbfbfbfbfbfbf
bfbfbfbfbfbfbfbfbfbfbfbfbfbfbfbfbfbfbfbfbfbfbfbfbfbfbfbfbfbf
bfbfbfbfbfbfbfbfbfbfbfbfbfbfbfbfbfbfbfbfbfbfbfbfbfbfbfbfbfbf
bfbfbfbfbfbfbfbfbfbfbfbfbfbfbfbfbfbfbfbfbfbfbfbfbfbfbfbfbfbf
bfbfbfbfbfbfbfbfbfbfbfbfbfbfbfbfbfbfbfbfbfbfbfbfbfbfbfbfbfbf
bfbfbfbfbfbfbfbfbfbfbfbfbfbfbfbfbfbfbfbfbfbfbfbfbfbfbfbfbfbf
"}
