"aa" = (/turf/wall/generic,/area/underground)
"ab" = (/turf/floor/generic/wooden,/area/underground)
"ac" = (/obj/electricity/lightbulb/east,/turf/floor/generic/wooden,/area/underground)
"ad" = (/turf/floor/generic/white,/area/underground)
"ae" = (/obj/electricity/lightbulb/west,/turf/floor/generic/wooden,/area/underground)
"af" = (/obj/electricity/lightbulb,/turf/floor/generic/wooden,/area/underground)
"ag" = (/obj/electricity/machine/door,/turf/floor/generic/red,/area/underground)
"ah" = (/obj/electricity/lightbulb/north,/turf/floor/generic/red,/area/underground)
"ai" = (/turf/floor/generic/red,/area/underground)
"aj" = (/obj/electricity/lightswitch/east,/turf/floor/generic/wooden,/area/underground)
"ak" = (/obj/electricity/lightbulb,/turf/floor/generic/red,/area/underground)
"al" = (/obj/electricity/elevator/button/west,/turf/floor/generic/red,/area/underground)
"am" = (/obj/electricity/machine/door,/turf/floor/generic/black,/area/underground)
"an" = (/turf/wall/generic,/area/elevator)
"ao" = (/obj/electricity/machine/door/elevator_door,/turf/floor/generic/black,/area/elevator)
"ap" = (/turf/floor/generic/black,/area/underground)
"aq" = (/turf/floor/generic/chess,/area/underground)
"ar" = (/obj/electricity/elevator/button/east,/turf/floor/generic/chess,/area/underground)
"as" = (/turf/floor/generic/black,/area/elevator)
"at" = (/obj/electricity/elevator/controls/north,/turf/floor/generic/black,/area/elevator)
"au" = (/obj/electricity/elevator/button/west,/turf/floor/generic/chess,/area/underground)
"av" = (/obj/electricity/lightbulb,/turf/floor/generic/black,/area/underground)
"aw" = (/obj/electricity/lightbulb/west,/turf/floor/generic/chess,/area/underground)
"ax" = (/obj/electricity/lightbulb/east,/turf/floor/generic/chess,/area/underground)
"ay" = (/obj/electricity/lightbulb/west,/turf/floor/generic/black,/area/elevator)
"az" = (/obj/electricity/lightbulb/east,/turf/floor/generic/black,/area/elevator)
"aA" = (/obj/electricity/machine/door,/turf/floor/generic/chess,/area/underground)
"aB" = (/liquid/lava,/turf/floor/generic/wooden,/area/underground)
"aC" = (/obj/item/ball,/turf/floor/generic/wooden,/area/underground)
"aD" = (/liquid/water,/turf/floor/generic/wooden,/area/underground)
"aE" = (/obj/electricity/lightbulb/north,/turf/floor/generic/wooden,/area/underground)
"aF" = (/obj/electricity/lightbulb/south,/turf/floor/generic/wooden,/area/underground)
"aG" = (/obj/electricity/elevator/button/south,/turf/floor/generic/wooden,/area/underground)
"aH" = (/turf/wall/generic,/area/elevator{name = "Elevator0"})
"aI" = (/obj/electricity/machine/door/elevator_door,/turf/floor/generic/black,/area/elevator{name = "Elevator0"})
"aJ" = (/turf/floor/generic/black,/area/elevator{name = "Elevator0"})
"aK" = (/obj/electricity/lightbulb/north,/turf/floor/generic/chess,/area/underground)
"aL" = (/obj/electricity/elevator/button/east,/turf/floor/generic/red,/area/underground)
"aM" = (/obj/electricity/lightbulb/south,/turf/floor/generic/chess,/area/underground)
"aN" = (/obj/electricity/elevator/button/north,/turf/floor/generic/white,/area/underground)
"aO" = (/obj/electricity/lightbulb,/turf/floor/generic/white,/area/underground)
"aP" = (/obj/electricity/lightbulb/south,/turf/floor/generic/red,/area/underground)
"aQ" = (/obj/electricity/lightbulb/north,/turf/floor/generic/white,/area/underground)
"aR" = (/obj/electricity/lightbulb/north,/turf/floor/generic,/area/underground)
"aS" = (/turf/floor/generic,/area/underground)
"aT" = (/obj/electricity/lightbulb/south,/turf/floor/generic,/area/underground)
"aU" = (/obj/electricity/lightbulb/east,/turf/floor/generic,/area/underground)
"aV" = (/obj/electricity/machine/door,/turf/floor/generic/wooden,/area/underground)
"aW" = (/obj/electricity/lightbulb/west,/turf/floor/generic,/area/underground)
"aX" = (/obj/electricity/lightbulb/south,/turf/floor/generic/white,/area/underground)
"aY" = (/obj/electricity/elevator/button/south,/turf/floor/generic/white,/area/underground)
"aZ" = (/turf/wall/generic,/area/elevator{name = "Elevator1"})
"ba" = (/obj/electricity/machine/door/elevator_door,/turf/floor/generic/black,/area/elevator{name = "Elevator1"})
"bb" = (/turf/floor/generic/black,/area/elevator{name = "Elevator1"})
"bc" = (/obj/electricity/elevator/button/south,/turf/floor/generic,/area/underground)
"bd" = (/obj/electricity/elevator/button/east,/turf/floor/generic,/area/underground)
"be" = (/obj/electricity/elevator/button/north,/turf/floor/generic/chess,/area/underground)
"bf" = (/obj/electricity/machine/door,/turf,/area/underground)
"bg" = (/obj/electricity/lightbulb/south,/turf/floor/generic/black,/area/underground)
"bh" = (/turf,/area/underground)

(1,1,1) = {"
aaaaaaaaaaaaaaaaaaaaaaaaaaaaaaaaaaaaaaaaaaaaaaaaaaaaaaaaaaaa
aaababababababababababababacaaaaadadadadadadadadadadadadadaa
aaaeabababababababababababacaaaaadadadadadadadadadadadadadaa
aaabababababafababababacaaaaaaaaaaaaadadadadadadadadadadadaa
aaabababababababababababagahaiaiahagadadadadadadadadadadadaa
aaabababababababababababagaiaiaiaiagadadadadadadadadadadadaa
aaabababababababababababagaiaiaiaiagadadadadadadadadadadadaa
aaabababababafababababajaaaiaiaiaiaaadadadadadadadadadadadaa
aaaeabababababababababacaaakaiaiakaaadadadadadadadadadadadaa
aaabababababababababababaaalaiaiaiaaadadadadadadadadadadadaa
aaamaaaaaaaaaaaaaaaaanananaoaoaoaoanananaaaaaaaaaaaaaaaaamaa
aaapaaaqaqaqaqaqaqaranasatasasasasasasanauaqaqaqaqaqaqaaapaa
aaavaaawaqaqaqaqaqaxanayasasasasasasazanawaqaqaqaqaqaqaaavaa
aaapaAaqaqaqaqaqaqaqaoasasasasasasasasaoaqaqaqaqaqaqaqaAapaa
aaapaaawaqaqaqaqaqaqaoasasasasasasasasaoaqaqaqaqaqaqaqaaapaa
aaavaaaqaqaqaqaqaqaxanayasasasasasasazanawaqaqaqaqaqaqaaavaa
aaapaaaqaqaqaqaqaqaqanasasasasasasasasanaqaqaqaqaqaqaqaaapaa
aaamaaaaaaaaaaaaaaaaanananaoaoaoaoanananaaaaaaaaaaaaaaaaamaa
aaababababababababababaBaaalaiaiaiaaadadadadadadadadadadadaa
aaabababababababababababaaaiaiaiaiaaadadadadadadadadadadadaa
aaabababababababababababaaaiaiaiaiaaadadadadadadadadadadadaa
aaabababafabaCabafabababaaaiaiaiaiaaadadadadadadadadadadadaa
aaabababababababababababaaaiaiaiaiaaadadadadadadadadadadadaa
aaabababababababababababaaaiaiaiaiaaadadadadadadadadadadadaa
aaabababababababababababaaaiaiaiaiaaadadadadadadadadadadadaa
aaabababafabababafabababaaaiaiaiaiaaadadadadadadadadadadadaa
aaabababababababababababagaiaiaiaiagadadadadadadadadadadadaa
aaabababababababababababagaiaiaiaiagadadadadadadadadadadadaa
aaaDababababababababababagaiaiaiaiagadadadadadadadadadadadaa
aaaaaaaaaaaaaaaaaaaaaaaaaaaaaaaaaaaaaaaaaaaaaaaaaaaaaaaaaaaa
"}

(1,1,2) = {"
aaaaaaaaaaaaaaaaaaaaaaaaaaaaaaaaaaaaaaaaaaaaaaaaaaaaaaaaaaaa
aaabababaEababababababaEababababababaEababababababaEabababaa
aaababababababababababababababababababababababababababababaa
aaababababababababababababababababababababababababababababaa
aaababababababababababababababababababababababababababababaa
aaababababababababababababababababababababababababababababaa
aaababababababababababababababababababababababababababababaa
aaababababababababababababababababababababababababababababaa
aaababababababababababababababababababababababababababababaa
aaabababaFababababababaFaGabababababaFababababababaFabababaa
aaaaagagaaaaaaaaaaaaaHaHaHaIaIaIaIaHaHaHaaaaaaaaaaaaaAaAaaaa
aaaiaiaiaiaiaiaiaiaiaHaJaJaJaJaJaJaJaJaHaqaqaqaKaqaKaqaqaqaa
aaaiaiaiaiaiaiaiaiaLaHaJaJaJaJaJaJaJaJaHauaqaqaqaqaqaqaqaqaa
aaaiaiaiaiaiaiaiaiaiaIaJaJaJaJaJaJaJaJaIaqaqaqaqaqaqaqaqaqaa
aaaiaiaiakaiakaiaiaiaIaJaJaJaJaJaJaJaJaIaqaqaqaqaqaqaqaqaqaa
aaaiaiaiaiaiaiaiaiaiaHaJaJaJaJaJaJaJaJaHaqaqaqaqaqaqaqaqaqaa
aaaiaiaiaiaiaiaiaiaiaHaJaJaJaJaJaJaJaJaHaqaqaqaMaqaMaqaqaqaa
aaaiaiaiaiaiaiaiaiaiaHaHaHaIaIaIaIaHaHaHaaaaaaaaaaaaaAaAaaaa
aaaiaiaiaiaiaiaiaiaiaaadaNadadadadadadadadadadadadadadadadaa
aaaiaiaiaiaiaiaiaiaiaaadadadadadadadadadadadadadadadadadadaa
aaaiaiaiaiaiaiaiaiaiaaadadadadadadadadadadadadadadadadadadaa
aaaiaiaiaiaiaiaiaiaiaaadadadaOadadadaOadadaOadadadaOadadadaa
aaaiaiaiakaiakaiaiaiaaadadadadadadadadadadadadadadadadadadaa
aaaiaiaiaiaiaiaiaiaiaaadadadadadadadadadadadadadadadadadadaa
aaaiaiaiaiaiaiaiaiaiaaadadadadadadadadadadadadadadadadadadaa
aaaiaiaiaiaiaiaiaiaiaaadadadaOadadadaOadadaOadadadaOadadadaa
aaaiaiaiaiaiaiaiaiaiagadadadadadadadadadadadadadadadadadadaa
aaaiaiaiaiaiaiaiaiaiagadadadadadadadadadadadadadadadadadadaa
aaaiaiaiaPaiaPaiaiaiaaadadadadadadadadadadadadadadadadadadaa
aaaaaaaaaaaaaaaaaaaaaaaaaaaaaaaaaaaaaaaaaaaaaaaaaaaaaaaaaaaa
"}

(1,1,3) = {"
aaaaaaaaaaaaaaaaaaaaaaaaaaaaaaaaaaaaaaaaaaaaaaaaaaaaaaaaaaaa
aaadaQadadadadadaQadadaQadadadadadaQadaaaRaSaRaSaRaSaRaSaRaa
aaadadadadadadadadadadadadadadadadadadaaaSaSaTaSaTaSaTaSaUaa
aaadadadadadadadadadadadadadadadadadadaaaVaVaaaaaaaaaaaSaSaa
aaadadadadadadadadadadadadadadadadadadaaababababababaaaWaUaa
aaadadadadadadadadadadadadadadadadadadaaaeababababacaaaSaSaa
aaadadadadadadadadadadadadadadadadadadaaababababababaaaWaUaa
aaadadadadadadadadadadadadadadadadadadaaababababababaaaSaSaa
aaadadadadadadadadadadadadadadadadadadaaababababababaaaWaUaa
aaadaXadadadadadaXadadaXaYadadadadaXadaaababababababaaaSaSaa
aaaaaaaaaaaaaaaaaaaaaZaZaZbabababaaZaZaZaeababababacaaaWaUaa
aaaSaSaSaSaSaSaSaSaSaZbbbbbbbbbbbbbbbbaZababababababaaaSaSaa
aaaWaSaSaSaSaSaSaSaUaZbbbbbbbbbbbbbbbbaZaaaaaaaaaaaaaaaWaUaa
aaaSaSaSaSaSaSaSaSaSbabbbbbbbbbbbbbbbbbaaSaRaSaRaSaRaSaSaSaa
aaaSaSaSaSaSaSaSaSaSbabbbbbbbbbbbbbbbbbabcaTaSaTaSaTaSaSaSaa
aaaSaSaSaSaSaSaSaSbdaZbbbbbbbbbbbbbbbbaZaaaaaaaaaaaaaaagagaa
aaaSaSaSaSaSaSaSaSaSaZbbbbbbbbbbbbbbbbaZaiaiaiaiaiaiaiaiaiaa
aaaSaSaSaSaSaSaSaSaSaZaZaZbabababaaZaZaZaiaiaiaiaiaiaiaiaiaa
aaaSaSaSaSaSaSaSaSaSaaawbeaqaqaqaqaqaxaaaiaiaiaiaiaiaiaiaiaa
aaaSaSaSaSaSaSaSaSaSaaaqaqaqaqaqaqaqaqagaiaiaiaiaiaiaiaiaiaa
aaaWaSaSaSaSaSaSaSaUaaaqaqaqaqaqaqaqaqagaiaiaiaiaiaiaiaiaiaa
aaaSaSaSaSaSaSaSaSaSaaawaqaqaqaqaqaqaxaaaiaiaiaiaiaiaiaiaiaa
aaaSaSaSaSaSaSaSaSaSaaaaaaaaaaaaaaaaaaaaaaaaaaaaaaaaaaaaaaaa
aaaSaSaSaSaSaSaSaSaSaaapadapaQapadapadapaQapadapadapaQapadaa
aaaSaSaSaSaSaSaSaSaSaaadapadapadapadapadapadapadapadapadapaa
aaaSaSaSaSaSaSaSaSaSbfapadapadapadapadapadapadapadapadapadaa
aaaSaSaSaSaSaSaSaSaSbfadapadapadapadapadapadapadapadapadapaa
aaaWaSaSaSaSaSaSaSaUaaapadapadapadapadapadapadapadapadapadaa
aaaSaSaSaSaSaSaSaSaSaaadapadbgadapadapadbgadapadapadbgadapaa
aaaaaaaaaaaaaaaaaaaaaaaaaaaaaaaaaaaaaaaaaaaaaaaaaaaaaaaaaaaa
"}

(1,1,4) = {"
bhbhbhbhbhbhbhbhbhbhbhbhbhbhbhbhbhbhbhbhbhbhbhbhbhbhbhbhbhbh
bhbhbhbhbhbhbhbhbhbhbhbhbhbhbhbhbhbhbhbhbhbhbhbhbhbhbhbhbhbh
bhbhbhbhbhbhbhbhbhbhbhbhbhbhbhbhbhbhbhbhbhbhbhbhbhbhbhbhbhbh
bhbhbhbhbhbhbhbhbhbhbhbhbhbhbhbhbhbhbhbhbhbhbhbhbhbhbhbhbhbh
bhbhbhbhbhbhbhbhbhbhbhbhbhbhbhbhbhbhbhbhbhbhbhbhbhbhbhbhbhbh
bhbhbhbhbhbhbhbhbhbhbhbhbhbhbhbhbhbhbhbhbhbhbhbhbhbhbhbhbhbh
bhbhbhbhbhbhbhbhbhbhbhbhbhbhbhbhbhbhbhbhbhbhbhbhbhbhbhbhbhbh
bhbhbhbhbhbhbhbhbhbhbhbhbhbhbhbhbhbhbhbhbhbhbhbhbhbhbhbhbhbh
bhbhbhbhbhbhbhbhbhbhbhbhbhbhbhbhbhbhbhbhbhbhbhbhbhbhbhbhbhbh
bhbhbhbhbhbhbhbhbhbhbhbhbhbhbhbhbhbhbhbhbhbhbhbhbhbhbhbhbhbh
bhbhbhbhbhbhbhbhbhbhbhbhbhbhbhbhbhbhbhbhbhbhbhbhbhbhbhbhbhbh
bhbhbhbhbhbhbhbhbhbhbhbhbhbhbhbhbhbhbhbhbhbhbhbhbhbhbhbhbhbh
bhbhbhbhbhbhbhbhbhbhbhbhbhbhbhbhbhbhbhbhbhbhbhbhbhbhbhbhbhbh
bhbhbhbhbhbhbhbhbhbhbhbhbhbhbhbhbhbhbhbhbhbhbhbhbhbhbhbhbhbh
bhbhbhbhbhbhbhbhbhbhbhbhbhbhbhbhbhbhbhbhbhbhbhbhbhbhbhbhbhbh
bhbhbhbhbhbhbhbhbhbhbhbhbhbhbhbhbhbhbhbhbhbhbhbhbhbhbhbhbhbh
bhbhbhbhbhbhbhbhbhbhbhbhbhbhbhbhbhbhbhbhbhbhbhbhbhbhbhbhbhbh
bhbhbhbhbhbhbhbhbhbhbhbhbhbhbhbhbhbhbhbhbhbhbhbhbhbhbhbhbhbh
bhbhbhbhbhbhbhbhbhbhbhbhbhbhbhbhbhbhbhbhbhbhbhbhbhbhbhbhbhbh
bhbhbhbhbhbhbhbhbhbhbhbhbhbhbhbhbhbhbhbhbhbhbhbhbhbhbhbhbhbh
bhbhbhbhbhbhbhbhbhbhbhbhbhbhbhbhbhbhbhbhbhbhbhbhbhbhbhbhbhbh
bhbhbhbhbhbhbhbhbhbhbhbhbhbhbhbhbhbhbhbhbhbhbhbhbhbhbhbhbhbh
bhbhbhbhbhbhbhbhbhbhbhbhbhbhbhbhbhbhbhbhbhbhbhbhbhbhbhbhbhbh
bhbhbhbhbhbhbhbhbhbhbhbhbhbhbhbhbhbhbhbhbhbhbhbhbhbhbhbhbhbh
bhbhbhbhbhbhbhbhbhbhbhbhbhbhbhbhbhbhbhbhbhbhbhbhbhbhbhbhbhbh
bhbhbhbhbhbhbhbhbhbhbhbhbhbhbhbhbhbhbhbhbhbhbhbhbhbhbhbhbhbh
bhbhbhbhbhbhbhbhbhbhbhbhbhbhbhbhbhbhbhbhbhbhbhbhbhbhbhbhbhbh
bhbhbhbhbhbhbhbhbhbhbhbhbhbhbhbhbhbhbhbhbhbhbhbhbhbhbhbhbhbh
bhbhbhbhbhbhbhbhbhbhbhbhbhbhbhbhbhbhbhbhbhbhbhbhbhbhbhbhbhbh
bhbhbhbhbhbhbhbhbhbhbhbhbhbhbhbhbhbhbhbhbhbhbhbhbhbhbhbhbhbh
"}

(1,1,5) = {"
bhbhbhbhbhbhbhbhbhbhbhbhbhbhbhbhbhbhbhbhbhbhbhbhbhbhbhbhbhbh
bhbhbhbhbhbhbhbhbhbhbhbhbhbhbhbhbhbhbhbhbhbhbhbhbhbhbhbhbhbh
bhbhbhbhbhbhbhbhbhbhbhbhbhbhbhbhbhbhbhbhbhbhbhbhbhbhbhbhbhbh
bhbhbhbhbhbhbhbhbhbhbhbhbhbhbhbhbhbhbhbhbhbhbhbhbhbhbhbhbhbh
bhbhbhbhbhbhbhbhbhbhbhbhbhbhbhbhbhbhbhbhbhbhbhbhbhbhbhbhbhbh
bhbhbhbhbhbhbhbhbhbhbhbhbhbhbhbhbhbhbhbhbhbhbhbhbhbhbhbhbhbh
bhbhbhbhbhbhbhbhbhbhbhbhbhbhbhbhbhbhbhbhbhbhbhbhbhbhbhbhbhbh
bhbhbhbhbhbhbhbhbhbhbhbhbhbhbhbhbhbhbhbhbhbhbhbhbhbhbhbhbhbh
bhbhbhbhbhbhbhbhbhbhbhbhbhbhbhbhbhbhbhbhbhbhbhbhbhbhbhbhbhbh
bhbhbhbhbhbhbhbhbhbhbhbhbhbhbhbhbhbhbhbhbhbhbhbhbhbhbhbhbhbh
bhbhbhbhbhbhbhbhbhbhbhbhbhbhbhbhbhbhbhbhbhbhbhbhbhbhbhbhbhbh
bhbhbhbhbhbhbhbhbhbhbhbhbhbhbhbhbhbhbhbhbhbhbhbhbhbhbhbhbhbh
bhbhbhbhbhbhbhbhbhbhbhbhbhbhbhbhbhbhbhbhbhbhbhbhbhbhbhbhbhbh
bhbhbhbhbhbhbhbhbhbhbhbhbhbhbhbhbhbhbhbhbhbhbhbhbhbhbhbhbhbh
bhbhbhbhbhbhbhbhbhbhbhbhbhbhbhbhbhbhbhbhbhbhbhbhbhbhbhbhbhbh
bhbhbhbhbhbhbhbhbhbhbhbhbhbhbhbhbhbhbhbhbhbhbhbhbhbhbhbhbhbh
bhbhbhbhbhbhbhbhbhbhbhbhbhbhbhbhbhbhbhbhbhbhbhbhbhbhbhbhbhbh
bhbhbhbhbhbhbhbhbhbhbhbhbhbhbhbhbhbhbhbhbhbhbhbhbhbhbhbhbhbh
bhbhbhbhbhbhbhbhbhbhbhbhbhbhbhbhbhbhbhbhbhbhbhbhbhbhbhbhbhbh
bhbhbhbhbhbhbhbhbhbhbhbhbhbhbhbhbhbhbhbhbhbhbhbhbhbhbhbhbhbh
bhbhbhbhbhbhbhbhbhbhbhbhbhbhbhbhbhbhbhbhbhbhbhbhbhbhbhbhbhbh
bhbhbhbhbhbhbhbhbhbhbhbhbhbhbhbhbhbhbhbhbhbhbhbhbhbhbhbhbhbh
bhbhbhbhbhbhbhbhbhbhbhbhbhbhbhbhbhbhbhbhbhbhbhbhbhbhbhbhbhbh
bhbhbhbhbhbhbhbhbhbhbhbhbhbhbhbhbhbhbhbhbhbhbhbhbhbhbhbhbhbh
bhbhbhbhbhbhbhbhbhbhbhbhbhbhbhbhbhbhbhbhbhbhbhbhbhbhbhbhbhbh
bhbhbhbhbhbhbhbhbhbhbhbhbhbhbhbhbhbhbhbhbhbhbhbhbhbhbhbhbhbh
bhbhbhbhbhbhbhbhbhbhbhbhbhbhbhbhbhbhbhbhbhbhbhbhbhbhbhbhbhbh
bhbhbhbhbhbhbhbhbhbhbhbhbhbhbhbhbhbhbhbhbhbhbhbhbhbhbhbhbhbh
bhbhbhbhbhbhbhbhbhbhbhbhbhbhbhbhbhbhbhbhbhbhbhbhbhbhbhbhbhbh
bhbhbhbhbhbhbhbhbhbhbhbhbhbhbhbhbhbhbhbhbhbhbhbhbhbhbhbhbhbh
"}
